Id,Id2,Geography,Estimate; Total:,Margin of Error; Total:,Estimate; Total: - With public assistance income,Margin of Error; Total: - With public assistance income,Estimate; Total: - No public assistance income,Margin of Error; Total: - No public assistance income
1500000US220710001001,2.2071E+11,"Block Group 1, Census Tract 1, Orleans Parish, Louisiana",435,92,12,18,423,92
1500000US220710001002,2.2071E+11,"Block Group 2, Census Tract 1, Orleans Parish, Louisiana",571,123,29,22,542,119
1500000US220710001003,2.2071E+11,"Block Group 3, Census Tract 1, Orleans Parish, Louisiana",322,79,0,12,322,79
1500000US220710002001,2.2071E+11,"Block Group 1, Census Tract 2, Orleans Parish, Louisiana",236,61,0,12,236,61
1500000US220710002002,2.2071E+11,"Block Group 2, Census Tract 2, Orleans Parish, Louisiana",310,61,0,12,310,61
1500000US220710003001,2.2071E+11,"Block Group 1, Census Tract 3, Orleans Parish, Louisiana",256,60,4,6,252,59
1500000US220710003002,2.2071E+11,"Block Group 2, Census Tract 3, Orleans Parish, Louisiana",237,54,13,13,224,58
1500000US220710004001,2.2071E+11,"Block Group 1, Census Tract 4, Orleans Parish, Louisiana",483,73,11,12,472,74
1500000US220710004002,2.2071E+11,"Block Group 2, Census Tract 4, Orleans Parish, Louisiana",421,83,5,8,416,80
1500000US220710006011,2.2071E+11,"Block Group 1, Census Tract 6.01, Orleans Parish, Louisiana",146,40,13,17,133,42
1500000US220710006012,2.2071E+11,"Block Group 2, Census Tract 6.01, Orleans Parish, Louisiana",168,68,14,21,154,59
1500000US220710006021,2.2071E+11,"Block Group 1, Census Tract 6.02, Orleans Parish, Louisiana",337,63,19,22,318,64
1500000US220710006022,2.2071E+11,"Block Group 2, Census Tract 6.02, Orleans Parish, Louisiana",239,60,16,15,223,60
1500000US220710006023,2.2071E+11,"Block Group 3, Census Tract 6.02, Orleans Parish, Louisiana",382,76,21,20,361,73
1500000US220710006031,2.2071E+11,"Block Group 1, Census Tract 6.03, Orleans Parish, Louisiana",197,57,0,12,197,57
1500000US220710006032,2.2071E+11,"Block Group 2, Census Tract 6.03, Orleans Parish, Louisiana",257,56,11,15,246,56
1500000US220710006041,2.2071E+11,"Block Group 1, Census Tract 6.04, Orleans Parish, Louisiana",453,107,20,23,433,105
1500000US220710006042,2.2071E+11,"Block Group 2, Census Tract 6.04, Orleans Parish, Louisiana",738,146,13,21,725,145
1500000US220710006043,2.2071E+11,"Block Group 3, Census Tract 6.04, Orleans Parish, Louisiana",324,103,5,10,319,104
1500000US220710006051,2.2071E+11,"Block Group 1, Census Tract 6.05, Orleans Parish, Louisiana",378,64,0,12,378,64
1500000US220710006052,2.2071E+11,"Block Group 2, Census Tract 6.05, Orleans Parish, Louisiana",174,49,10,15,164,47
1500000US220710006053,2.2071E+11,"Block Group 3, Census Tract 6.05, Orleans Parish, Louisiana",230,48,4,6,226,47
1500000US220710006061,2.2071E+11,"Block Group 1, Census Tract 6.06, Orleans Parish, Louisiana",538,99,20,24,518,102
1500000US220710006062,2.2071E+11,"Block Group 2, Census Tract 6.06, Orleans Parish, Louisiana",567,109,0,12,567,109
1500000US220710006063,2.2071E+11,"Block Group 3, Census Tract 6.06, Orleans Parish, Louisiana",531,108,32,33,499,109
1500000US220710006071,2.2071E+11,"Block Group 1, Census Tract 6.07, Orleans Parish, Louisiana",307,99,0,12,307,99
1500000US220710006072,2.2071E+11,"Block Group 2, Census Tract 6.07, Orleans Parish, Louisiana",536,93,0,12,536,93
1500000US220710006073,2.2071E+11,"Block Group 3, Census Tract 6.07, Orleans Parish, Louisiana",706,100,0,12,706,100
1500000US220710006111,2.2071E+11,"Block Group 1, Census Tract 6.11, Orleans Parish, Louisiana",536,93,10,15,526,91
1500000US220710006112,2.2071E+11,"Block Group 2, Census Tract 6.11, Orleans Parish, Louisiana",974,106,38,33,936,104
1500000US220710006121,2.2071E+11,"Block Group 1, Census Tract 6.12, Orleans Parish, Louisiana",538,68,0,12,538,68
1500000US220710006131,2.2071E+11,"Block Group 1, Census Tract 6.13, Orleans Parish, Louisiana",289,86,0,12,289,86
1500000US220710006132,2.2071E+11,"Block Group 2, Census Tract 6.13, Orleans Parish, Louisiana",520,132,14,22,506,129
1500000US220710006133,2.2071E+11,"Block Group 3, Census Tract 6.13, Orleans Parish, Louisiana",1243,130,31,25,1212,134
1500000US220710006151,2.2071E+11,"Block Group 1, Census Tract 6.15, Orleans Parish, Louisiana",621,132,18,22,603,136
1500000US220710006152,2.2071E+11,"Block Group 2, Census Tract 6.15, Orleans Parish, Louisiana",1065,173,0,12,1065,173
1500000US220710006161,2.2071E+11,"Block Group 1, Census Tract 6.16, Orleans Parish, Louisiana",348,101,0,12,348,101
1500000US220710006162,2.2071E+11,"Block Group 2, Census Tract 6.16, Orleans Parish, Louisiana",491,150,0,12,491,150
1500000US220710006163,2.2071E+11,"Block Group 3, Census Tract 6.16, Orleans Parish, Louisiana",636,126,0,12,636,126
1500000US220710006171,2.2071E+11,"Block Group 1, Census Tract 6.17, Orleans Parish, Louisiana",750,202,0,12,750,202
1500000US220710006172,2.2071E+11,"Block Group 2, Census Tract 6.17, Orleans Parish, Louisiana",1180,202,0,12,1180,202
1500000US220710006181,2.2071E+11,"Block Group 1, Census Tract 6.18, Orleans Parish, Louisiana",543,78,0,12,543,78
1500000US220710006182,2.2071E+11,"Block Group 2, Census Tract 6.18, Orleans Parish, Louisiana",750,98,21,30,729,101
1500000US220710007011,2.2071E+11,"Block Group 1, Census Tract 7.01, Orleans Parish, Louisiana",28,23,0,12,28,23
1500000US220710007012,2.2071E+11,"Block Group 2, Census Tract 7.01, Orleans Parish, Louisiana",45,21,0,12,45,21
1500000US220710007013,2.2071E+11,"Block Group 3, Census Tract 7.01, Orleans Parish, Louisiana",74,27,0,12,74,27
1500000US220710007014,2.2071E+11,"Block Group 4, Census Tract 7.01, Orleans Parish, Louisiana",75,27,8,9,67,27
1500000US220710007021,2.2071E+11,"Block Group 1, Census Tract 7.02, Orleans Parish, Louisiana",131,54,17,27,114,51
1500000US220710007022,2.2071E+11,"Block Group 2, Census Tract 7.02, Orleans Parish, Louisiana",252,68,0,12,252,68
1500000US220710007023,2.2071E+11,"Block Group 3, Census Tract 7.02, Orleans Parish, Louisiana",52,29,10,16,42,32
1500000US220710007024,2.2071E+11,"Block Group 4, Census Tract 7.02, Orleans Parish, Louisiana",176,77,26,36,150,63
1500000US220710008001,2.2071E+11,"Block Group 1, Census Tract 8, Orleans Parish, Louisiana",149,47,14,16,135,46
1500000US220710008002,2.2071E+11,"Block Group 2, Census Tract 8, Orleans Parish, Louisiana",165,53,47,40,118,40
1500000US220710008003,2.2071E+11,"Block Group 3, Census Tract 8, Orleans Parish, Louisiana",179,53,22,22,157,54
1500000US220710009011,2.2071E+11,"Block Group 1, Census Tract 9.01, Orleans Parish, Louisiana",59,28,0,12,59,28
1500000US220710009012,2.2071E+11,"Block Group 2, Census Tract 9.01, Orleans Parish, Louisiana",81,49,0,12,81,49
1500000US220710009013,2.2071E+11,"Block Group 3, Census Tract 9.01, Orleans Parish, Louisiana",38,27,0,12,38,27
1500000US220710009014,2.2071E+11,"Block Group 4, Census Tract 9.01, Orleans Parish, Louisiana",124,49,0,12,124,49
1500000US220710009021,2.2071E+11,"Block Group 1, Census Tract 9.02, Orleans Parish, Louisiana",14,10,0,12,14,10
1500000US220710009022,2.2071E+11,"Block Group 2, Census Tract 9.02, Orleans Parish, Louisiana",35,30,0,12,35,30
1500000US220710009023,2.2071E+11,"Block Group 3, Census Tract 9.02, Orleans Parish, Louisiana",67,40,0,12,67,40
1500000US220710009024,2.2071E+11,"Block Group 4, Census Tract 9.02, Orleans Parish, Louisiana",29,19,0,12,29,19
1500000US220710009031,2.2071E+11,"Block Group 1, Census Tract 9.03, Orleans Parish, Louisiana",55,31,0,12,55,31
1500000US220710009032,2.2071E+11,"Block Group 2, Census Tract 9.03, Orleans Parish, Louisiana",88,31,1,4,87,32
1500000US220710009033,2.2071E+11,"Block Group 3, Census Tract 9.03, Orleans Parish, Louisiana",22,19,0,12,22,19
1500000US220710009034,2.2071E+11,"Block Group 4, Census Tract 9.03, Orleans Parish, Louisiana",41,24,0,12,41,24
1500000US220710009041,2.2071E+11,"Block Group 1, Census Tract 9.04, Orleans Parish, Louisiana",193,51,8,13,185,50
1500000US220710009042,2.2071E+11,"Block Group 2, Census Tract 9.04, Orleans Parish, Louisiana",161,51,13,16,148,49
1500000US220710011001,2.2071E+11,"Block Group 1, Census Tract 11, Orleans Parish, Louisiana",274,72,0,12,274,72
1500000US220710011002,2.2071E+11,"Block Group 2, Census Tract 11, Orleans Parish, Louisiana",639,83,31,26,608,87
1500000US220710011003,2.2071E+11,"Block Group 3, Census Tract 11, Orleans Parish, Louisiana",0,12,0,12,0,12
1500000US220710012001,2.2071E+11,"Block Group 1, Census Tract 12, Orleans Parish, Louisiana",322,65,0,12,322,65
1500000US220710012002,2.2071E+11,"Block Group 2, Census Tract 12, Orleans Parish, Louisiana",223,49,9,12,214,47
1500000US220710012003,2.2071E+11,"Block Group 3, Census Tract 12, Orleans Parish, Louisiana",342,69,0,12,342,69
1500000US220710013011,2.2071E+11,"Block Group 1, Census Tract 13.01, Orleans Parish, Louisiana",307,58,42,35,265,63
1500000US220710013012,2.2071E+11,"Block Group 2, Census Tract 13.01, Orleans Parish, Louisiana",165,44,0,12,165,44
1500000US220710013013,2.2071E+11,"Block Group 3, Census Tract 13.01, Orleans Parish, Louisiana",160,42,0,12,160,42
1500000US220710013014,2.2071E+11,"Block Group 4, Census Tract 13.01, Orleans Parish, Louisiana",149,60,35,36,114,51
1500000US220710013021,2.2071E+11,"Block Group 1, Census Tract 13.02, Orleans Parish, Louisiana",193,52,7,11,186,53
1500000US220710013022,2.2071E+11,"Block Group 2, Census Tract 13.02, Orleans Parish, Louisiana",246,58,69,50,177,58
1500000US220710014011,2.2071E+11,"Block Group 1, Census Tract 14.01, Orleans Parish, Louisiana",113,39,0,12,113,39
1500000US220710014012,2.2071E+11,"Block Group 2, Census Tract 14.01, Orleans Parish, Louisiana",74,27,4,7,70,28
1500000US220710014013,2.2071E+11,"Block Group 3, Census Tract 14.01, Orleans Parish, Louisiana",145,49,7,12,138,50
1500000US220710014014,2.2071E+11,"Block Group 4, Census Tract 14.01, Orleans Parish, Louisiana",99,34,22,25,77,23
1500000US220710014015,2.2071E+11,"Block Group 5, Census Tract 14.01, Orleans Parish, Louisiana",44,36,0,12,44,36
1500000US220710014016,2.2071E+11,"Block Group 6, Census Tract 14.01, Orleans Parish, Louisiana",53,30,0,12,53,30
1500000US220710014021,2.2071E+11,"Block Group 1, Census Tract 14.02, Orleans Parish, Louisiana",240,57,6,12,234,55
1500000US220710014022,2.2071E+11,"Block Group 2, Census Tract 14.02, Orleans Parish, Louisiana",118,46,5,8,113,46
1500000US220710014023,2.2071E+11,"Block Group 3, Census Tract 14.02, Orleans Parish, Louisiana",136,53,0,12,136,53
1500000US220710014024,2.2071E+11,"Block Group 4, Census Tract 14.02, Orleans Parish, Louisiana",265,56,45,34,220,52
1500000US220710015001,2.2071E+11,"Block Group 1, Census Tract 15, Orleans Parish, Louisiana",219,53,15,18,204,50
1500000US220710015002,2.2071E+11,"Block Group 2, Census Tract 15, Orleans Parish, Louisiana",141,40,17,13,124,38
1500000US220710016001,2.2071E+11,"Block Group 1, Census Tract 16, Orleans Parish, Louisiana",0,12,0,12,0,12
1500000US220710017011,2.2071E+11,"Block Group 1, Census Tract 17.01, Orleans Parish, Louisiana",229,48,6,9,223,50
1500000US220710017012,2.2071E+11,"Block Group 2, Census Tract 17.01, Orleans Parish, Louisiana",155,39,0,12,155,39
1500000US220710017013,2.2071E+11,"Block Group 3, Census Tract 17.01, Orleans Parish, Louisiana",180,42,0,12,180,42
1500000US220710017021,2.2071E+11,"Block Group 1, Census Tract 17.02, Orleans Parish, Louisiana",313,65,0,12,313,65
1500000US220710017022,2.2071E+11,"Block Group 2, Census Tract 17.02, Orleans Parish, Louisiana",306,65,0,12,306,65
1500000US220710017023,2.2071E+11,"Block Group 3, Census Tract 17.02, Orleans Parish, Louisiana",154,46,0,12,154,46
1500000US220710017024,2.2071E+11,"Block Group 4, Census Tract 17.02, Orleans Parish, Louisiana",150,49,0,12,150,49
1500000US220710017201,2.2071E+11,"Block Group 1, Census Tract 17.20, Orleans Parish, Louisiana",192,64,6,10,186,64
1500000US220710017202,2.2071E+11,"Block Group 2, Census Tract 17.20, Orleans Parish, Louisiana",235,74,0,12,235,74
1500000US220710017203,2.2071E+11,"Block Group 3, Census Tract 17.20, Orleans Parish, Louisiana",445,93,18,21,427,94
1500000US220710017204,2.2071E+11,"Block Group 4, Census Tract 17.20, Orleans Parish, Louisiana",321,95,0,12,321,95
1500000US220710017221,2.2071E+11,"Block Group 1, Census Tract 17.22, Orleans Parish, Louisiana",167,82,12,20,155,79
1500000US220710017222,2.2071E+11,"Block Group 2, Census Tract 17.22, Orleans Parish, Louisiana",253,81,0,12,253,81
1500000US220710017223,2.2071E+11,"Block Group 3, Census Tract 17.22, Orleans Parish, Louisiana",431,80,0,12,431,80
1500000US220710017224,2.2071E+11,"Block Group 4, Census Tract 17.22, Orleans Parish, Louisiana",172,54,0,12,172,54
1500000US220710017225,2.2071E+11,"Block Group 5, Census Tract 17.22, Orleans Parish, Louisiana",349,80,7,11,342,80
1500000US220710017226,2.2071E+11,"Block Group 6, Census Tract 17.22, Orleans Parish, Louisiana",123,62,0,12,123,62
1500000US220710017227,2.2071E+11,"Block Group 7, Census Tract 17.22, Orleans Parish, Louisiana",121,66,0,12,121,66
1500000US220710017231,2.2071E+11,"Block Group 1, Census Tract 17.23, Orleans Parish, Louisiana",272,82,0,12,272,82
1500000US220710017232,2.2071E+11,"Block Group 2, Census Tract 17.23, Orleans Parish, Louisiana",738,108,19,21,719,111
1500000US220710017233,2.2071E+11,"Block Group 3, Census Tract 17.23, Orleans Parish, Louisiana",331,89,6,10,325,89
1500000US220710017234,2.2071E+11,"Block Group 4, Census Tract 17.23, Orleans Parish, Louisiana",508,102,0,12,508,102
1500000US220710017241,2.2071E+11,"Block Group 1, Census Tract 17.24, Orleans Parish, Louisiana",268,83,27,31,241,82
1500000US220710017242,2.2071E+11,"Block Group 2, Census Tract 17.24, Orleans Parish, Louisiana",356,90,0,12,356,90
1500000US220710017243,2.2071E+11,"Block Group 3, Census Tract 17.24, Orleans Parish, Louisiana",612,118,7,12,605,117
1500000US220710017244,2.2071E+11,"Block Group 4, Census Tract 17.24, Orleans Parish, Louisiana",426,119,13,18,413,117
1500000US220710017251,2.2071E+11,"Block Group 1, Census Tract 17.25, Orleans Parish, Louisiana",765,156,0,12,765,156
1500000US220710017252,2.2071E+11,"Block Group 2, Census Tract 17.25, Orleans Parish, Louisiana",559,129,16,22,543,132
1500000US220710017253,2.2071E+11,"Block Group 3, Census Tract 17.25, Orleans Parish, Louisiana",521,127,0,12,521,127
1500000US220710017254,2.2071E+11,"Block Group 4, Census Tract 17.25, Orleans Parish, Louisiana",569,139,16,25,553,142
1500000US220710017301,2.2071E+11,"Block Group 1, Census Tract 17.30, Orleans Parish, Louisiana",287,46,0,12,287,46
1500000US220710017341,2.2071E+11,"Block Group 1, Census Tract 17.34, Orleans Parish, Louisiana",333,70,0,12,333,70
1500000US220710017351,2.2071E+11,"Block Group 1, Census Tract 17.35, Orleans Parish, Louisiana",454,85,26,24,428,88
1500000US220710017352,2.2071E+11,"Block Group 2, Census Tract 17.35, Orleans Parish, Louisiana",350,67,31,23,319,71
1500000US220710017361,2.2071E+11,"Block Group 1, Census Tract 17.36, Orleans Parish, Louisiana",241,69,11,18,230,66
1500000US220710017362,2.2071E+11,"Block Group 2, Census Tract 17.36, Orleans Parish, Louisiana",559,82,6,10,553,83
1500000US220710017371,2.2071E+11,"Block Group 1, Census Tract 17.37, Orleans Parish, Louisiana",724,112,17,27,707,115
1500000US220710017372,2.2071E+11,"Block Group 2, Census Tract 17.37, Orleans Parish, Louisiana",322,66,0,12,322,66
1500000US220710017373,2.2071E+11,"Block Group 3, Census Tract 17.37, Orleans Parish, Louisiana",249,63,13,13,236,63
1500000US220710017391,2.2071E+11,"Block Group 1, Census Tract 17.39, Orleans Parish, Louisiana",408,67,0,12,408,67
1500000US220710017392,2.2071E+11,"Block Group 2, Census Tract 17.39, Orleans Parish, Louisiana",165,43,0,12,165,43
1500000US220710017401,2.2071E+11,"Block Group 1, Census Tract 17.40, Orleans Parish, Louisiana",442,93,10,16,432,93
1500000US220710017402,2.2071E+11,"Block Group 2, Census Tract 17.40, Orleans Parish, Louisiana",695,128,0,12,695,128
1500000US220710017403,2.2071E+11,"Block Group 3, Census Tract 17.40, Orleans Parish, Louisiana",656,127,45,51,611,121
1500000US220710017411,2.2071E+11,"Block Group 1, Census Tract 17.41, Orleans Parish, Louisiana",480,44,3,6,477,45
1500000US220710017431,2.2071E+11,"Block Group 1, Census Tract 17.43, Orleans Parish, Louisiana",625,105,14,16,611,106
1500000US220710017432,2.2071E+11,"Block Group 2, Census Tract 17.43, Orleans Parish, Louisiana",314,101,0,12,314,101
1500000US220710017441,2.2071E+11,"Block Group 1, Census Tract 17.44, Orleans Parish, Louisiana",489,106,11,19,478,109
1500000US220710017442,2.2071E+11,"Block Group 2, Census Tract 17.44, Orleans Parish, Louisiana",493,139,72,79,421,134
1500000US220710017443,2.2071E+11,"Block Group 3, Census Tract 17.44, Orleans Parish, Louisiana",427,97,15,23,412,95
1500000US220710017451,2.2071E+11,"Block Group 1, Census Tract 17.45, Orleans Parish, Louisiana",930,106,39,29,891,106
1500000US220710017452,2.2071E+11,"Block Group 2, Census Tract 17.45, Orleans Parish, Louisiana",409,79,17,21,392,76
1500000US220710017461,2.2071E+11,"Block Group 1, Census Tract 17.46, Orleans Parish, Louisiana",482,126,9,14,473,127
1500000US220710017462,2.2071E+11,"Block Group 2, Census Tract 17.46, Orleans Parish, Louisiana",578,116,0,12,578,116
1500000US220710017463,2.2071E+11,"Block Group 3, Census Tract 17.46, Orleans Parish, Louisiana",563,131,41,39,522,137
1500000US220710017471,2.2071E+11,"Block Group 1, Census Tract 17.47, Orleans Parish, Louisiana",847,104,0,12,847,104
1500000US220710017472,2.2071E+11,"Block Group 2, Census Tract 17.47, Orleans Parish, Louisiana",425,90,0,12,425,90
1500000US220710017481,2.2071E+11,"Block Group 1, Census Tract 17.48, Orleans Parish, Louisiana",374,84,0,12,374,84
1500000US220710017482,2.2071E+11,"Block Group 2, Census Tract 17.48, Orleans Parish, Louisiana",409,98,0,12,409,98
1500000US220710017483,2.2071E+11,"Block Group 3, Census Tract 17.48, Orleans Parish, Louisiana",445,101,24,36,421,100
1500000US220710017484,2.2071E+11,"Block Group 4, Census Tract 17.48, Orleans Parish, Louisiana",273,88,0,12,273,88
1500000US220710017491,2.2071E+11,"Block Group 1, Census Tract 17.49, Orleans Parish, Louisiana",369,69,5,8,364,70
1500000US220710017492,2.2071E+11,"Block Group 2, Census Tract 17.49, Orleans Parish, Louisiana",471,78,3,5,468,78
1500000US220710017501,2.2071E+11,"Block Group 1, Census Tract 17.50, Orleans Parish, Louisiana",397,89,0,12,397,89
1500000US220710017502,2.2071E+11,"Block Group 2, Census Tract 17.50, Orleans Parish, Louisiana",322,87,0,12,322,87
1500000US220710017503,2.2071E+11,"Block Group 3, Census Tract 17.50, Orleans Parish, Louisiana",434,93,18,29,416,93
1500000US220710017511,2.2071E+11,"Block Group 1, Census Tract 17.51, Orleans Parish, Louisiana",268,45,21,19,247,48
1500000US220710018001,2.2071E+11,"Block Group 1, Census Tract 18, Orleans Parish, Louisiana",418,75,3,6,415,75
1500000US220710018002,2.2071E+11,"Block Group 2, Census Tract 18, Orleans Parish, Louisiana",282,65,0,12,282,65
1500000US220710019001,2.2071E+11,"Block Group 1, Census Tract 19, Orleans Parish, Louisiana",138,51,0,12,138,51
1500000US220710019002,2.2071E+11,"Block Group 2, Census Tract 19, Orleans Parish, Louisiana",261,58,19,22,242,56
1500000US220710019003,2.2071E+11,"Block Group 3, Census Tract 19, Orleans Parish, Louisiana",245,70,0,12,245,70
1500000US220710020001,2.2071E+11,"Block Group 1, Census Tract 20, Orleans Parish, Louisiana",212,63,32,30,180,59
1500000US220710020002,2.2071E+11,"Block Group 2, Census Tract 20, Orleans Parish, Louisiana",197,65,14,16,183,69
1500000US220710020003,2.2071E+11,"Block Group 3, Census Tract 20, Orleans Parish, Louisiana",107,46,10,15,97,44
1500000US220710021001,2.2071E+11,"Block Group 1, Census Tract 21, Orleans Parish, Louisiana",158,57,15,16,143,55
1500000US220710021002,2.2071E+11,"Block Group 2, Census Tract 21, Orleans Parish, Louisiana",209,47,36,30,173,39
1500000US220710022001,2.2071E+11,"Block Group 1, Census Tract 22, Orleans Parish, Louisiana",125,44,1,4,124,45
1500000US220710022002,2.2071E+11,"Block Group 2, Census Tract 22, Orleans Parish, Louisiana",181,43,15,20,166,42
1500000US220710022003,2.2071E+11,"Block Group 3, Census Tract 22, Orleans Parish, Louisiana",96,44,11,18,85,43
1500000US220710023001,2.2071E+11,"Block Group 1, Census Tract 23, Orleans Parish, Louisiana",59,27,0,12,59,27
1500000US220710023002,2.2071E+11,"Block Group 2, Census Tract 23, Orleans Parish, Louisiana",114,56,14,20,100,56
1500000US220710023003,2.2071E+11,"Block Group 3, Census Tract 23, Orleans Parish, Louisiana",68,45,0,12,68,45
1500000US220710023004,2.2071E+11,"Block Group 4, Census Tract 23, Orleans Parish, Louisiana",101,42,0,12,101,42
1500000US220710023005,2.2071E+11,"Block Group 5, Census Tract 23, Orleans Parish, Louisiana",475,88,0,12,475,88
1500000US220710024011,2.2071E+11,"Block Group 1, Census Tract 24.01, Orleans Parish, Louisiana",414,75,5,8,409,73
1500000US220710024012,2.2071E+11,"Block Group 2, Census Tract 24.01, Orleans Parish, Louisiana",355,78,6,10,349,78
1500000US220710024021,2.2071E+11,"Block Group 1, Census Tract 24.02, Orleans Parish, Louisiana",168,68,0,12,168,68
1500000US220710024022,2.2071E+11,"Block Group 2, Census Tract 24.02, Orleans Parish, Louisiana",355,110,0,12,355,110
1500000US220710024023,2.2071E+11,"Block Group 3, Census Tract 24.02, Orleans Parish, Louisiana",276,84,0,12,276,84
1500000US220710024024,2.2071E+11,"Block Group 4, Census Tract 24.02, Orleans Parish, Louisiana",419,83,0,12,419,83
1500000US220710025011,2.2071E+11,"Block Group 1, Census Tract 25.01, Orleans Parish, Louisiana",278,64,6,9,272,66
1500000US220710025012,2.2071E+11,"Block Group 2, Census Tract 25.01, Orleans Parish, Louisiana",161,52,1,4,160,53
1500000US220710025013,2.2071E+11,"Block Group 3, Census Tract 25.01, Orleans Parish, Louisiana",105,41,0,12,105,41
1500000US220710025014,2.2071E+11,"Block Group 4, Census Tract 25.01, Orleans Parish, Louisiana",130,37,0,12,130,37
1500000US220710025021,2.2071E+11,"Block Group 1, Census Tract 25.02, Orleans Parish, Louisiana",320,67,17,16,303,68
1500000US220710025022,2.2071E+11,"Block Group 2, Census Tract 25.02, Orleans Parish, Louisiana",179,56,0,12,179,56
1500000US220710025023,2.2071E+11,"Block Group 3, Census Tract 25.02, Orleans Parish, Louisiana",142,52,0,12,142,52
1500000US220710025024,2.2071E+11,"Block Group 4, Census Tract 25.02, Orleans Parish, Louisiana",171,48,0,12,171,48
1500000US220710025031,2.2071E+11,"Block Group 1, Census Tract 25.03, Orleans Parish, Louisiana",150,45,5,8,145,43
1500000US220710025032,2.2071E+11,"Block Group 2, Census Tract 25.03, Orleans Parish, Louisiana",377,82,0,12,377,82
1500000US220710025033,2.2071E+11,"Block Group 3, Census Tract 25.03, Orleans Parish, Louisiana",281,63,0,12,281,63
1500000US220710025041,2.2071E+11,"Block Group 1, Census Tract 25.04, Orleans Parish, Louisiana",191,57,29,34,162,49
1500000US220710025042,2.2071E+11,"Block Group 2, Census Tract 25.04, Orleans Parish, Louisiana",328,59,0,12,328,59
1500000US220710025043,2.2071E+11,"Block Group 3, Census Tract 25.04, Orleans Parish, Louisiana",181,46,0,12,181,46
1500000US220710025044,2.2071E+11,"Block Group 4, Census Tract 25.04, Orleans Parish, Louisiana",229,53,0,12,229,53
1500000US220710026001,2.2071E+11,"Block Group 1, Census Tract 26, Orleans Parish, Louisiana",450,92,8,12,442,92
1500000US220710026002,2.2071E+11,"Block Group 2, Census Tract 26, Orleans Parish, Louisiana",528,108,0,12,528,108
1500000US220710027001,2.2071E+11,"Block Group 1, Census Tract 27, Orleans Parish, Louisiana",205,60,0,12,205,60
1500000US220710027002,2.2071E+11,"Block Group 2, Census Tract 27, Orleans Parish, Louisiana",261,69,4,6,257,70
1500000US220710027003,2.2071E+11,"Block Group 3, Census Tract 27, Orleans Parish, Louisiana",149,54,11,21,138,57
1500000US220710028001,2.2071E+11,"Block Group 1, Census Tract 28, Orleans Parish, Louisiana",170,43,0,12,170,43
1500000US220710028002,2.2071E+11,"Block Group 2, Census Tract 28, Orleans Parish, Louisiana",269,62,5,8,264,62
1500000US220710028003,2.2071E+11,"Block Group 3, Census Tract 28, Orleans Parish, Louisiana",202,61,6,11,196,62
1500000US220710029001,2.2071E+11,"Block Group 1, Census Tract 29, Orleans Parish, Louisiana",209,64,6,9,203,63
1500000US220710029002,2.2071E+11,"Block Group 2, Census Tract 29, Orleans Parish, Louisiana",147,61,0,12,147,61
1500000US220710029003,2.2071E+11,"Block Group 3, Census Tract 29, Orleans Parish, Louisiana",208,84,0,12,208,84
1500000US220710030001,2.2071E+11,"Block Group 1, Census Tract 30, Orleans Parish, Louisiana",213,58,6,9,207,57
1500000US220710030002,2.2071E+11,"Block Group 2, Census Tract 30, Orleans Parish, Louisiana",268,65,5,8,263,65
1500000US220710031001,2.2071E+11,"Block Group 1, Census Tract 31, Orleans Parish, Louisiana",147,67,0,12,147,67
1500000US220710031002,2.2071E+11,"Block Group 2, Census Tract 31, Orleans Parish, Louisiana",303,75,10,15,293,75
1500000US220710033011,2.2071E+11,"Block Group 1, Census Tract 33.01, Orleans Parish, Louisiana",300,57,5,8,295,55
1500000US220710033012,2.2071E+11,"Block Group 2, Census Tract 33.01, Orleans Parish, Louisiana",252,72,14,22,238,73
1500000US220710033013,2.2071E+11,"Block Group 3, Census Tract 33.01, Orleans Parish, Louisiana",129,39,0,12,129,39
1500000US220710033021,2.2071E+11,"Block Group 1, Census Tract 33.02, Orleans Parish, Louisiana",231,70,0,12,231,70
1500000US220710033022,2.2071E+11,"Block Group 2, Census Tract 33.02, Orleans Parish, Louisiana",398,78,26,41,372,73
1500000US220710033023,2.2071E+11,"Block Group 3, Census Tract 33.02, Orleans Parish, Louisiana",371,79,0,12,371,79
1500000US220710033024,2.2071E+11,"Block Group 4, Census Tract 33.02, Orleans Parish, Louisiana",214,64,0,12,214,64
1500000US220710033031,2.2071E+11,"Block Group 1, Census Tract 33.03, Orleans Parish, Louisiana",356,70,23,28,333,70
1500000US220710033032,2.2071E+11,"Block Group 2, Census Tract 33.03, Orleans Parish, Louisiana",307,81,15,24,292,78
1500000US220710033033,2.2071E+11,"Block Group 3, Census Tract 33.03, Orleans Parish, Louisiana",176,52,4,7,172,52
1500000US220710033041,2.2071E+11,"Block Group 1, Census Tract 33.04, Orleans Parish, Louisiana",392,64,23,21,369,61
1500000US220710033042,2.2071E+11,"Block Group 2, Census Tract 33.04, Orleans Parish, Louisiana",373,60,5,7,368,61
1500000US220710033071,2.2071E+11,"Block Group 1, Census Tract 33.07, Orleans Parish, Louisiana",334,66,5,8,329,64
1500000US220710033072,2.2071E+11,"Block Group 2, Census Tract 33.07, Orleans Parish, Louisiana",231,47,0,12,231,47
1500000US220710033081,2.2071E+11,"Block Group 1, Census Tract 33.08, Orleans Parish, Louisiana",131,54,0,12,131,54
1500000US220710033082,2.2071E+11,"Block Group 2, Census Tract 33.08, Orleans Parish, Louisiana",269,75,10,17,259,76
1500000US220710033083,2.2071E+11,"Block Group 3, Census Tract 33.08, Orleans Parish, Louisiana",500,89,0,12,500,89
1500000US220710033084,2.2071E+11,"Block Group 4, Census Tract 33.08, Orleans Parish, Louisiana",215,63,0,12,215,63
1500000US220710033085,2.2071E+11,"Block Group 5, Census Tract 33.08, Orleans Parish, Louisiana",199,66,0,12,199,66
1500000US220710033086,2.2071E+11,"Block Group 6, Census Tract 33.08, Orleans Parish, Louisiana",47,32,0,12,47,32
1500000US220710034001,2.2071E+11,"Block Group 1, Census Tract 34, Orleans Parish, Louisiana",276,63,0,12,276,63
1500000US220710034002,2.2071E+11,"Block Group 2, Census Tract 34, Orleans Parish, Louisiana",408,79,20,32,388,75
1500000US220710035001,2.2071E+11,"Block Group 1, Census Tract 35, Orleans Parish, Louisiana",237,54,0,12,237,54
1500000US220710035002,2.2071E+11,"Block Group 2, Census Tract 35, Orleans Parish, Louisiana",165,56,11,18,154,55
1500000US220710035003,2.2071E+11,"Block Group 3, Census Tract 35, Orleans Parish, Louisiana",218,55,0,12,218,55
1500000US220710036001,2.2071E+11,"Block Group 1, Census Tract 36, Orleans Parish, Louisiana",210,47,0,12,210,47
1500000US220710036002,2.2071E+11,"Block Group 2, Census Tract 36, Orleans Parish, Louisiana",395,55,0,12,395,55
1500000US220710036003,2.2071E+11,"Block Group 3, Census Tract 36, Orleans Parish, Louisiana",208,59,18,19,190,58
1500000US220710037011,2.2071E+11,"Block Group 1, Census Tract 37.01, Orleans Parish, Louisiana",782,91,0,12,782,91
1500000US220710037012,2.2071E+11,"Block Group 2, Census Tract 37.01, Orleans Parish, Louisiana",248,58,0,12,248,58
1500000US220710037021,2.2071E+11,"Block Group 1, Census Tract 37.02, Orleans Parish, Louisiana",320,98,0,12,320,98
1500000US220710037022,2.2071E+11,"Block Group 2, Census Tract 37.02, Orleans Parish, Louisiana",293,89,0,12,293,89
1500000US220710037023,2.2071E+11,"Block Group 3, Census Tract 37.02, Orleans Parish, Louisiana",179,68,4,7,175,68
1500000US220710037024,2.2071E+11,"Block Group 4, Census Tract 37.02, Orleans Parish, Louisiana",255,77,0,12,255,77
1500000US220710037025,2.2071E+11,"Block Group 5, Census Tract 37.02, Orleans Parish, Louisiana",228,79,0,12,228,79
1500000US220710037026,2.2071E+11,"Block Group 6, Census Tract 37.02, Orleans Parish, Louisiana",380,101,0,12,380,101
1500000US220710038001,2.2071E+11,"Block Group 1, Census Tract 38, Orleans Parish, Louisiana",437,101,0,12,437,101
1500000US220710038002,2.2071E+11,"Block Group 2, Census Tract 38, Orleans Parish, Louisiana",420,104,0,12,420,104
1500000US220710039001,2.2071E+11,"Block Group 1, Census Tract 39, Orleans Parish, Louisiana",303,54,6,9,297,55
1500000US220710039002,2.2071E+11,"Block Group 2, Census Tract 39, Orleans Parish, Louisiana",362,71,14,13,348,74
1500000US220710040001,2.2071E+11,"Block Group 1, Census Tract 40, Orleans Parish, Louisiana",393,108,12,13,381,108
1500000US220710040002,2.2071E+11,"Block Group 2, Census Tract 40, Orleans Parish, Louisiana",528,104,14,18,514,106
1500000US220710041001,2.2071E+11,"Block Group 1, Census Tract 41, Orleans Parish, Louisiana",437,77,0,12,437,77
1500000US220710041002,2.2071E+11,"Block Group 2, Census Tract 41, Orleans Parish, Louisiana",352,58,15,19,337,58
1500000US220710044011,2.2071E+11,"Block Group 1, Census Tract 44.01, Orleans Parish, Louisiana",179,62,12,13,167,66
1500000US220710044012,2.2071E+11,"Block Group 2, Census Tract 44.01, Orleans Parish, Louisiana",153,58,0,12,153,58
1500000US220710044013,2.2071E+11,"Block Group 3, Census Tract 44.01, Orleans Parish, Louisiana",227,62,0,12,227,62
1500000US220710044021,2.2071E+11,"Block Group 1, Census Tract 44.02, Orleans Parish, Louisiana",37,62,0,12,37,62
1500000US220710044022,2.2071E+11,"Block Group 2, Census Tract 44.02, Orleans Parish, Louisiana",0,12,0,12,0,12
1500000US220710045001,2.2071E+11,"Block Group 1, Census Tract 45, Orleans Parish, Louisiana",225,68,0,12,225,68
1500000US220710045002,2.2071E+11,"Block Group 2, Census Tract 45, Orleans Parish, Louisiana",338,75,59,45,279,66
1500000US220710045003,2.2071E+11,"Block Group 3, Census Tract 45, Orleans Parish, Louisiana",479,95,17,19,462,91
1500000US220710046001,2.2071E+11,"Block Group 1, Census Tract 46, Orleans Parish, Louisiana",269,68,0,12,269,68
1500000US220710046002,2.2071E+11,"Block Group 2, Census Tract 46, Orleans Parish, Louisiana",804,94,18,28,786,93
1500000US220710046003,2.2071E+11,"Block Group 3, Census Tract 46, Orleans Parish, Louisiana",428,89,0,12,428,89
1500000US220710048001,2.2071E+11,"Block Group 1, Census Tract 48, Orleans Parish, Louisiana",376,94,6,8,370,94
1500000US220710049001,2.2071E+11,"Block Group 1, Census Tract 49, Orleans Parish, Louisiana",296,77,31,40,265,74
1500000US220710049002,2.2071E+11,"Block Group 2, Census Tract 49, Orleans Parish, Louisiana",234,64,6,8,228,62
1500000US220710049003,2.2071E+11,"Block Group 3, Census Tract 49, Orleans Parish, Louisiana",12,19,0,12,12,19
1500000US220710049004,2.2071E+11,"Block Group 4, Census Tract 49, Orleans Parish, Louisiana",119,43,6,9,113,43
1500000US220710050001,2.2071E+11,"Block Group 1, Census Tract 50, Orleans Parish, Louisiana",302,57,11,14,291,54
1500000US220710050002,2.2071E+11,"Block Group 2, Census Tract 50, Orleans Parish, Louisiana",303,59,26,27,277,58
1500000US220710054001,2.2071E+11,"Block Group 1, Census Tract 54, Orleans Parish, Louisiana",329,89,4,8,325,90
1500000US220710054002,2.2071E+11,"Block Group 2, Census Tract 54, Orleans Parish, Louisiana",324,99,0,12,324,99
1500000US220710054003,2.2071E+11,"Block Group 3, Census Tract 54, Orleans Parish, Louisiana",350,83,4,7,346,82
1500000US220710055001,2.2071E+11,"Block Group 1, Census Tract 55, Orleans Parish, Louisiana",437,74,0,12,437,74
1500000US220710055002,2.2071E+11,"Block Group 2, Census Tract 55, Orleans Parish, Louisiana",401,74,8,12,393,72
1500000US220710055003,2.2071E+11,"Block Group 3, Census Tract 55, Orleans Parish, Louisiana",370,74,6,11,364,75
1500000US220710056011,2.2071E+11,"Block Group 1, Census Tract 56.01, Orleans Parish, Louisiana",257,62,0,12,257,62
1500000US220710056012,2.2071E+11,"Block Group 2, Census Tract 56.01, Orleans Parish, Louisiana",252,55,0,12,252,55
1500000US220710056013,2.2071E+11,"Block Group 3, Census Tract 56.01, Orleans Parish, Louisiana",176,33,0,12,176,33
1500000US220710056014,2.2071E+11,"Block Group 4, Census Tract 56.01, Orleans Parish, Louisiana",191,37,0,12,191,37
1500000US220710056021,2.2071E+11,"Block Group 1, Census Tract 56.02, Orleans Parish, Louisiana",156,39,0,12,156,39
1500000US220710056022,2.2071E+11,"Block Group 2, Census Tract 56.02, Orleans Parish, Louisiana",327,51,0,12,327,51
1500000US220710056023,2.2071E+11,"Block Group 3, Census Tract 56.02, Orleans Parish, Louisiana",295,56,0,12,295,56
1500000US220710056024,2.2071E+11,"Block Group 4, Census Tract 56.02, Orleans Parish, Louisiana",173,55,0,12,173,55
1500000US220710056031,2.2071E+11,"Block Group 1, Census Tract 56.03, Orleans Parish, Louisiana",215,44,0,12,215,44
1500000US220710056032,2.2071E+11,"Block Group 2, Census Tract 56.03, Orleans Parish, Louisiana",228,48,0,12,228,48
1500000US220710056033,2.2071E+11,"Block Group 3, Census Tract 56.03, Orleans Parish, Louisiana",168,44,0,12,168,44
1500000US220710056041,2.2071E+11,"Block Group 1, Census Tract 56.04, Orleans Parish, Louisiana",195,57,0,12,195,57
1500000US220710056042,2.2071E+11,"Block Group 2, Census Tract 56.04, Orleans Parish, Louisiana",229,44,0,12,229,44
1500000US220710056043,2.2071E+11,"Block Group 3, Census Tract 56.04, Orleans Parish, Louisiana",174,39,0,12,174,39
1500000US220710060001,2.2071E+11,"Block Group 1, Census Tract 60, Orleans Parish, Louisiana",584,66,27,28,557,74
1500000US220710063001,2.2071E+11,"Block Group 1, Census Tract 63, Orleans Parish, Louisiana",363,68,5,7,358,68
1500000US220710063002,2.2071E+11,"Block Group 2, Census Tract 63, Orleans Parish, Louisiana",77,40,0,12,77,40
1500000US220710063003,2.2071E+11,"Block Group 3, Census Tract 63, Orleans Parish, Louisiana",229,61,0,12,229,61
1500000US220710064001,2.2071E+11,"Block Group 1, Census Tract 64, Orleans Parish, Louisiana",253,60,15,20,238,56
1500000US220710064002,2.2071E+11,"Block Group 2, Census Tract 64, Orleans Parish, Louisiana",331,78,0,12,331,78
1500000US220710064003,2.2071E+11,"Block Group 3, Census Tract 64, Orleans Parish, Louisiana",202,63,14,20,188,63
1500000US220710064004,2.2071E+11,"Block Group 4, Census Tract 64, Orleans Parish, Louisiana",242,60,0,12,242,60
1500000US220710065001,2.2071E+11,"Block Group 1, Census Tract 65, Orleans Parish, Louisiana",418,75,20,19,398,75
1500000US220710065002,2.2071E+11,"Block Group 2, Census Tract 65, Orleans Parish, Louisiana",375,68,17,21,358,73
1500000US220710065003,2.2071E+11,"Block Group 3, Census Tract 65, Orleans Parish, Louisiana",391,76,6,10,385,76
1500000US220710069001,2.2071E+11,"Block Group 1, Census Tract 69, Orleans Parish, Louisiana",103,37,3,5,100,38
1500000US220710069002,2.2071E+11,"Block Group 2, Census Tract 69, Orleans Parish, Louisiana",19,17,0,12,19,17
1500000US220710069003,2.2071E+11,"Block Group 3, Census Tract 69, Orleans Parish, Louisiana",153,40,0,12,153,40
1500000US220710070001,2.2071E+11,"Block Group 1, Census Tract 70, Orleans Parish, Louisiana",70,44,0,12,70,44
1500000US220710070002,2.2071E+11,"Block Group 2, Census Tract 70, Orleans Parish, Louisiana",136,38,0,12,136,38
1500000US220710071011,2.2071E+11,"Block Group 1, Census Tract 71.01, Orleans Parish, Louisiana",329,63,9,14,320,64
1500000US220710071012,2.2071E+11,"Block Group 2, Census Tract 71.01, Orleans Parish, Louisiana",790,88,0,12,790,88
1500000US220710072001,2.2071E+11,"Block Group 1, Census Tract 72, Orleans Parish, Louisiana",630,88,33,32,597,91
1500000US220710072002,2.2071E+11,"Block Group 2, Census Tract 72, Orleans Parish, Louisiana",278,81,0,12,278,81
1500000US220710072003,2.2071E+11,"Block Group 3, Census Tract 72, Orleans Parish, Louisiana",119,48,8,13,111,47
1500000US220710075011,2.2071E+11,"Block Group 1, Census Tract 75.01, Orleans Parish, Louisiana",206,70,0,12,206,70
1500000US220710075012,2.2071E+11,"Block Group 2, Census Tract 75.01, Orleans Parish, Louisiana",220,64,14,21,206,67
1500000US220710075013,2.2071E+11,"Block Group 3, Census Tract 75.01, Orleans Parish, Louisiana",217,69,0,12,217,69
1500000US220710075014,2.2071E+11,"Block Group 4, Census Tract 75.01, Orleans Parish, Louisiana",188,66,0,12,188,66
1500000US220710075015,2.2071E+11,"Block Group 5, Census Tract 75.01, Orleans Parish, Louisiana",139,66,0,12,139,66
1500000US220710075021,2.2071E+11,"Block Group 1, Census Tract 75.02, Orleans Parish, Louisiana",116,61,0,12,116,61
1500000US220710075022,2.2071E+11,"Block Group 2, Census Tract 75.02, Orleans Parish, Louisiana",131,65,9,13,122,69
1500000US220710075023,2.2071E+11,"Block Group 3, Census Tract 75.02, Orleans Parish, Louisiana",311,64,0,12,311,64
1500000US220710075024,2.2071E+11,"Block Group 4, Census Tract 75.02, Orleans Parish, Louisiana",162,70,0,12,162,70
1500000US220710075025,2.2071E+11,"Block Group 5, Census Tract 75.02, Orleans Parish, Louisiana",287,84,9,14,278,83
1500000US220710076041,2.2071E+11,"Block Group 1, Census Tract 76.04, Orleans Parish, Louisiana",369,63,0,12,369,63
1500000US220710076042,2.2071E+11,"Block Group 2, Census Tract 76.04, Orleans Parish, Louisiana",286,40,0,12,286,40
1500000US220710076051,2.2071E+11,"Block Group 1, Census Tract 76.05, Orleans Parish, Louisiana",275,52,0,12,275,52
1500000US220710076052,2.2071E+11,"Block Group 2, Census Tract 76.05, Orleans Parish, Louisiana",334,48,0,12,334,48
1500000US220710076061,2.2071E+11,"Block Group 1, Census Tract 76.06, Orleans Parish, Louisiana",761,102,0,12,761,102
1500000US220710076062,2.2071E+11,"Block Group 2, Census Tract 76.06, Orleans Parish, Louisiana",432,83,0,12,432,83
1500000US220710076063,2.2071E+11,"Block Group 3, Census Tract 76.06, Orleans Parish, Louisiana",636,93,0,12,636,93
1500000US220710077001,2.2071E+11,"Block Group 1, Census Tract 77, Orleans Parish, Louisiana",877,121,9,15,868,122
1500000US220710077002,2.2071E+11,"Block Group 2, Census Tract 77, Orleans Parish, Louisiana",751,119,15,22,736,116
1500000US220710078001,2.2071E+11,"Block Group 1, Census Tract 78, Orleans Parish, Louisiana",671,73,13,18,658,73
1500000US220710082001,2.2071E+11,"Block Group 1, Census Tract 82, Orleans Parish, Louisiana",454,94,0,12,454,94
1500000US220710082002,2.2071E+11,"Block Group 2, Census Tract 82, Orleans Parish, Louisiana",482,105,0,12,482,105
1500000US220710083001,2.2071E+11,"Block Group 1, Census Tract 83, Orleans Parish, Louisiana",321,52,5,9,316,52
1500000US220710083002,2.2071E+11,"Block Group 2, Census Tract 83, Orleans Parish, Louisiana",232,55,0,12,232,55
1500000US220710084001,2.2071E+11,"Block Group 1, Census Tract 84, Orleans Parish, Louisiana",336,72,15,15,321,75
1500000US220710084002,2.2071E+11,"Block Group 2, Census Tract 84, Orleans Parish, Louisiana",358,67,0,12,358,67
1500000US220710085001,2.2071E+11,"Block Group 1, Census Tract 85, Orleans Parish, Louisiana",330,97,33,38,297,93
1500000US220710085002,2.2071E+11,"Block Group 2, Census Tract 85, Orleans Parish, Louisiana",245,84,8,9,237,84
1500000US220710086001,2.2071E+11,"Block Group 1, Census Tract 86, Orleans Parish, Louisiana",216,49,0,12,216,49
1500000US220710086002,2.2071E+11,"Block Group 2, Census Tract 86, Orleans Parish, Louisiana",199,47,13,17,186,45
1500000US220710088001,2.2071E+11,"Block Group 1, Census Tract 88, Orleans Parish, Louisiana",411,85,9,15,402,83
1500000US220710088002,2.2071E+11,"Block Group 2, Census Tract 88, Orleans Parish, Louisiana",456,82,8,12,448,81
1500000US220710090001,2.2071E+11,"Block Group 1, Census Tract 90, Orleans Parish, Louisiana",305,75,0,12,305,75
1500000US220710090002,2.2071E+11,"Block Group 2, Census Tract 90, Orleans Parish, Louisiana",286,78,0,12,286,78
1500000US220710090003,2.2071E+11,"Block Group 3, Census Tract 90, Orleans Parish, Louisiana",428,92,14,22,414,95
1500000US220710091001,2.2071E+11,"Block Group 1, Census Tract 91, Orleans Parish, Louisiana",342,105,0,12,342,105
1500000US220710091002,2.2071E+11,"Block Group 2, Census Tract 91, Orleans Parish, Louisiana",186,68,0,12,186,68
1500000US220710091003,2.2071E+11,"Block Group 3, Census Tract 91, Orleans Parish, Louisiana",181,84,8,13,173,86
1500000US220710091004,2.2071E+11,"Block Group 4, Census Tract 91, Orleans Parish, Louisiana",409,98,0,12,409,98
1500000US220710092001,2.2071E+11,"Block Group 1, Census Tract 92, Orleans Parish, Louisiana",150,69,5,7,145,70
1500000US220710092002,2.2071E+11,"Block Group 2, Census Tract 92, Orleans Parish, Louisiana",216,56,10,16,206,57
1500000US220710092003,2.2071E+11,"Block Group 3, Census Tract 92, Orleans Parish, Louisiana",243,62,5,8,238,64
1500000US220710094001,2.2071E+11,"Block Group 1, Census Tract 94, Orleans Parish, Louisiana",164,57,0,12,164,57
1500000US220710094002,2.2071E+11,"Block Group 2, Census Tract 94, Orleans Parish, Louisiana",74,39,0,12,74,39
1500000US220710094003,2.2071E+11,"Block Group 3, Census Tract 94, Orleans Parish, Louisiana",114,48,0,12,114,48
1500000US220710094004,2.2071E+11,"Block Group 4, Census Tract 94, Orleans Parish, Louisiana",150,44,5,7,145,45
1500000US220710096001,2.2071E+11,"Block Group 1, Census Tract 96, Orleans Parish, Louisiana",262,59,14,16,248,60
1500000US220710096002,2.2071E+11,"Block Group 2, Census Tract 96, Orleans Parish, Louisiana",246,59,0,12,246,59
1500000US220710096003,2.2071E+11,"Block Group 3, Census Tract 96, Orleans Parish, Louisiana",228,53,3,6,225,54
1500000US220710097001,2.2071E+11,"Block Group 1, Census Tract 97, Orleans Parish, Louisiana",368,61,5,8,363,61
1500000US220710097002,2.2071E+11,"Block Group 2, Census Tract 97, Orleans Parish, Louisiana",353,66,3,6,350,66
1500000US220710099001,2.2071E+11,"Block Group 1, Census Tract 99, Orleans Parish, Louisiana",520,87,0,12,520,87
1500000US220710099002,2.2071E+11,"Block Group 2, Census Tract 99, Orleans Parish, Louisiana",443,77,12,18,431,79
1500000US220710099003,2.2071E+11,"Block Group 3, Census Tract 99, Orleans Parish, Louisiana",475,98,0,12,475,98
1500000US220710100001,2.2071E+11,"Block Group 1, Census Tract 100, Orleans Parish, Louisiana",142,60,0,12,142,60
1500000US220710100002,2.2071E+11,"Block Group 2, Census Tract 100, Orleans Parish, Louisiana",193,54,5,9,188,56
1500000US220710100003,2.2071E+11,"Block Group 3, Census Tract 100, Orleans Parish, Louisiana",308,69,0,12,308,69
1500000US220710100004,2.2071E+11,"Block Group 4, Census Tract 100, Orleans Parish, Louisiana",121,38,0,12,121,38
1500000US220710101001,2.2071E+11,"Block Group 1, Census Tract 101, Orleans Parish, Louisiana",318,83,7,11,311,81
1500000US220710101002,2.2071E+11,"Block Group 2, Census Tract 101, Orleans Parish, Louisiana",607,87,0,12,607,87
1500000US220710102001,2.2071E+11,"Block Group 1, Census Tract 102, Orleans Parish, Louisiana",151,63,0,12,151,63
1500000US220710102002,2.2071E+11,"Block Group 2, Census Tract 102, Orleans Parish, Louisiana",102,52,21,24,81,51
1500000US220710102003,2.2071E+11,"Block Group 3, Census Tract 102, Orleans Parish, Louisiana",128,55,5,8,123,56
1500000US220710102004,2.2071E+11,"Block Group 4, Census Tract 102, Orleans Parish, Louisiana",155,48,14,23,141,41
1500000US220710102005,2.2071E+11,"Block Group 5, Census Tract 102, Orleans Parish, Louisiana",200,53,0,12,200,53
1500000US220710103001,2.2071E+11,"Block Group 1, Census Tract 103, Orleans Parish, Louisiana",259,87,0,12,259,87
1500000US220710103002,2.2071E+11,"Block Group 2, Census Tract 103, Orleans Parish, Louisiana",329,88,30,36,299,96
1500000US220710103003,2.2071E+11,"Block Group 3, Census Tract 103, Orleans Parish, Louisiana",263,57,0,12,263,57
1500000US220710103004,2.2071E+11,"Block Group 4, Census Tract 103, Orleans Parish, Louisiana",182,82,0,12,182,82
1500000US220710106001,2.2071E+11,"Block Group 1, Census Tract 106, Orleans Parish, Louisiana",316,60,12,14,304,60
1500000US220710106002,2.2071E+11,"Block Group 2, Census Tract 106, Orleans Parish, Louisiana",366,75,0,12,366,75
1500000US220710107001,2.2071E+11,"Block Group 1, Census Tract 107, Orleans Parish, Louisiana",280,61,0,12,280,61
1500000US220710107002,2.2071E+11,"Block Group 2, Census Tract 107, Orleans Parish, Louisiana",593,85,0,12,593,85
1500000US220710108001,2.2071E+11,"Block Group 1, Census Tract 108, Orleans Parish, Louisiana",173,42,0,12,173,42
1500000US220710108002,2.2071E+11,"Block Group 2, Census Tract 108, Orleans Parish, Louisiana",492,62,0,12,492,62
1500000US220710109001,2.2071E+11,"Block Group 1, Census Tract 109, Orleans Parish, Louisiana",269,76,0,12,269,76
1500000US220710109002,2.2071E+11,"Block Group 2, Census Tract 109, Orleans Parish, Louisiana",504,92,0,12,504,92
1500000US220710109003,2.2071E+11,"Block Group 3, Census Tract 109, Orleans Parish, Louisiana",381,90,0,12,381,90
1500000US220710109004,2.2071E+11,"Block Group 4, Census Tract 109, Orleans Parish, Louisiana",272,84,0,12,272,84
1500000US220710111001,2.2071E+11,"Block Group 1, Census Tract 111, Orleans Parish, Louisiana",192,59,0,12,192,59
1500000US220710111002,2.2071E+11,"Block Group 2, Census Tract 111, Orleans Parish, Louisiana",291,68,0,12,291,68
1500000US220710111003,2.2071E+11,"Block Group 3, Census Tract 111, Orleans Parish, Louisiana",154,50,0,12,154,50
1500000US220710112001,2.2071E+11,"Block Group 1, Census Tract 112, Orleans Parish, Louisiana",288,62,0,12,288,62
1500000US220710112002,2.2071E+11,"Block Group 2, Census Tract 112, Orleans Parish, Louisiana",309,45,7,9,302,46
1500000US220710114001,2.2071E+11,"Block Group 1, Census Tract 114, Orleans Parish, Louisiana",445,86,0,12,445,86
1500000US220710114002,2.2071E+11,"Block Group 2, Census Tract 114, Orleans Parish, Louisiana",555,83,0,12,555,83
1500000US220710115001,2.2071E+11,"Block Group 1, Census Tract 115, Orleans Parish, Louisiana",286,52,0,12,286,52
1500000US220710115002,2.2071E+11,"Block Group 2, Census Tract 115, Orleans Parish, Louisiana",350,73,0,12,350,73
1500000US220710116001,2.2071E+11,"Block Group 1, Census Tract 116, Orleans Parish, Louisiana",354,54,0,12,354,54
1500000US220710116002,2.2071E+11,"Block Group 2, Census Tract 116, Orleans Parish, Louisiana",304,40,0,12,304,40
1500000US220710117001,2.2071E+11,"Block Group 1, Census Tract 117, Orleans Parish, Louisiana",210,64,0,12,210,64
1500000US220710117002,2.2071E+11,"Block Group 2, Census Tract 117, Orleans Parish, Louisiana",240,58,0,12,240,58
1500000US220710117003,2.2071E+11,"Block Group 3, Census Tract 117, Orleans Parish, Louisiana",315,75,0,12,315,75
1500000US220710117004,2.2071E+11,"Block Group 4, Census Tract 117, Orleans Parish, Louisiana",330,60,0,12,330,60
1500000US220710119001,2.2071E+11,"Block Group 1, Census Tract 119, Orleans Parish, Louisiana",226,61,0,12,226,61
1500000US220710119002,2.2071E+11,"Block Group 2, Census Tract 119, Orleans Parish, Louisiana",247,49,0,12,247,49
1500000US220710119003,2.2071E+11,"Block Group 3, Census Tract 119, Orleans Parish, Louisiana",225,53,0,12,225,53
1500000US220710120001,2.2071E+11,"Block Group 1, Census Tract 120, Orleans Parish, Louisiana",504,55,0,12,504,55
1500000US220710120002,2.2071E+11,"Block Group 2, Census Tract 120, Orleans Parish, Louisiana",176,36,0,12,176,36
1500000US220710121011,2.2071E+11,"Block Group 1, Census Tract 121.01, Orleans Parish, Louisiana",406,62,0,12,406,62
1500000US220710121012,2.2071E+11,"Block Group 2, Census Tract 121.01, Orleans Parish, Louisiana",429,60,0,12,429,60
1500000US220710121021,2.2071E+11,"Block Group 1, Census Tract 121.02, Orleans Parish, Louisiana",203,41,4,8,199,42
1500000US220710121022,2.2071E+11,"Block Group 2, Census Tract 121.02, Orleans Parish, Louisiana",16,9,0,12,16,9
1500000US220710121023,2.2071E+11,"Block Group 3, Census Tract 121.02, Orleans Parish, Louisiana",219,47,0,12,219,47
1500000US220710122001,2.2071E+11,"Block Group 1, Census Tract 122, Orleans Parish, Louisiana",495,70,13,14,482,71
1500000US220710122002,2.2071E+11,"Block Group 2, Census Tract 122, Orleans Parish, Louisiana",426,73,7,10,419,73
1500000US220710123001,2.2071E+11,"Block Group 1, Census Tract 123, Orleans Parish, Louisiana",229,62,19,21,210,60
1500000US220710123002,2.2071E+11,"Block Group 2, Census Tract 123, Orleans Parish, Louisiana",336,74,11,17,325,75
1500000US220710123003,2.2071E+11,"Block Group 3, Census Tract 123, Orleans Parish, Louisiana",344,71,0,12,344,71
1500000US220710124001,2.2071E+11,"Block Group 1, Census Tract 124, Orleans Parish, Louisiana",267,76,0,12,267,76
1500000US220710124002,2.2071E+11,"Block Group 2, Census Tract 124, Orleans Parish, Louisiana",405,62,10,15,395,65
1500000US220710125001,2.2071E+11,"Block Group 1, Census Tract 125, Orleans Parish, Louisiana",278,57,0,12,278,57
1500000US220710125002,2.2071E+11,"Block Group 2, Census Tract 125, Orleans Parish, Louisiana",528,71,4,6,524,71
1500000US220710126001,2.2071E+11,"Block Group 1, Census Tract 126, Orleans Parish, Louisiana",294,49,0,12,294,49
1500000US220710126002,2.2071E+11,"Block Group 2, Census Tract 126, Orleans Parish, Louisiana",317,64,0,12,317,64
1500000US220710126003,2.2071E+11,"Block Group 3, Census Tract 126, Orleans Parish, Louisiana",270,59,0,12,270,59
1500000US220710127001,2.2071E+11,"Block Group 1, Census Tract 127, Orleans Parish, Louisiana",343,77,0,12,343,77
1500000US220710127002,2.2071E+11,"Block Group 2, Census Tract 127, Orleans Parish, Louisiana",209,60,0,12,209,60
1500000US220710127003,2.2071E+11,"Block Group 3, Census Tract 127, Orleans Parish, Louisiana",220,67,7,10,213,66
1500000US220710127004,2.2071E+11,"Block Group 4, Census Tract 127, Orleans Parish, Louisiana",235,47,0,12,235,47
1500000US220710128001,2.2071E+11,"Block Group 1, Census Tract 128, Orleans Parish, Louisiana",253,71,0,12,253,71
1500000US220710128002,2.2071E+11,"Block Group 2, Census Tract 128, Orleans Parish, Louisiana",340,58,0,12,340,58
1500000US220710128003,2.2071E+11,"Block Group 3, Census Tract 128, Orleans Parish, Louisiana",378,61,0,12,378,61
1500000US220710129001,2.2071E+11,"Block Group 1, Census Tract 129, Orleans Parish, Louisiana",470,68,6,9,464,67
1500000US220710129002,2.2071E+11,"Block Group 2, Census Tract 129, Orleans Parish, Louisiana",283,59,0,12,283,59
1500000US220710130001,2.2071E+11,"Block Group 1, Census Tract 130, Orleans Parish, Louisiana",293,78,0,12,293,78
1500000US220710130002,2.2071E+11,"Block Group 2, Census Tract 130, Orleans Parish, Louisiana",239,67,0,12,239,67
1500000US220710130003,2.2071E+11,"Block Group 3, Census Tract 130, Orleans Parish, Louisiana",214,64,0,12,214,64
1500000US220710131001,2.2071E+11,"Block Group 1, Census Tract 131, Orleans Parish, Louisiana",115,44,10,19,105,43
1500000US220710131002,2.2071E+11,"Block Group 2, Census Tract 131, Orleans Parish, Louisiana",146,44,11,17,135,43
1500000US220710131003,2.2071E+11,"Block Group 3, Census Tract 131, Orleans Parish, Louisiana",157,49,0,12,157,49
1500000US220710131004,2.2071E+11,"Block Group 4, Census Tract 131, Orleans Parish, Louisiana",143,56,0,12,143,56
1500000US220710132001,2.2071E+11,"Block Group 1, Census Tract 132, Orleans Parish, Louisiana",208,66,0,12,208,66
1500000US220710132002,2.2071E+11,"Block Group 2, Census Tract 132, Orleans Parish, Louisiana",313,101,10,15,303,100
1500000US220710132003,2.2071E+11,"Block Group 3, Census Tract 132, Orleans Parish, Louisiana",294,85,19,20,275,86
1500000US220710132004,2.2071E+11,"Block Group 4, Census Tract 132, Orleans Parish, Louisiana",245,63,0,12,245,63
1500000US220710133011,2.2071E+11,"Block Group 1, Census Tract 133.01, Orleans Parish, Louisiana",315,60,0,12,315,60
1500000US220710133012,2.2071E+11,"Block Group 2, Census Tract 133.01, Orleans Parish, Louisiana",504,74,0,12,504,74
1500000US220710133013,2.2071E+11,"Block Group 3, Census Tract 133.01, Orleans Parish, Louisiana",180,41,0,12,180,41
1500000US220710133014,2.2071E+11,"Block Group 4, Census Tract 133.01, Orleans Parish, Louisiana",412,86,0,12,412,86
1500000US220710133021,2.2071E+11,"Block Group 1, Census Tract 133.02, Orleans Parish, Louisiana",523,71,0,12,523,71
1500000US220710133022,2.2071E+11,"Block Group 2, Census Tract 133.02, Orleans Parish, Louisiana",358,52,7,10,351,53
1500000US220710134001,2.2071E+11,"Block Group 1, Census Tract 134, Orleans Parish, Louisiana",239,70,6,11,233,70
1500000US220710134002,2.2071E+11,"Block Group 2, Census Tract 134, Orleans Parish, Louisiana",395,64,10,16,385,69
1500000US220710134003,2.2071E+11,"Block Group 3, Census Tract 134, Orleans Parish, Louisiana",815,124,12,19,803,123
1500000US220710135001,2.2071E+11,"Block Group 1, Census Tract 135, Orleans Parish, Louisiana",226,77,0,12,226,77
1500000US220710135002,2.2071E+11,"Block Group 2, Census Tract 135, Orleans Parish, Louisiana",342,95,0,12,342,95
1500000US220710135003,2.2071E+11,"Block Group 3, Census Tract 135, Orleans Parish, Louisiana",318,95,0,12,318,95
1500000US220710135004,2.2071E+11,"Block Group 4, Census Tract 135, Orleans Parish, Louisiana",416,133,0,12,416,133
1500000US220710136001,2.2071E+11,"Block Group 1, Census Tract 136, Orleans Parish, Louisiana",261,59,0,12,261,59
1500000US220710136002,2.2071E+11,"Block Group 2, Census Tract 136, Orleans Parish, Louisiana",166,45,21,29,145,41
1500000US220710137001,2.2071E+11,"Block Group 1, Census Tract 137, Orleans Parish, Louisiana",0,12,0,12,0,12
1500000US220710137002,2.2071E+11,"Block Group 2, Census Tract 137, Orleans Parish, Louisiana",69,30,0,12,69,30
1500000US220710137003,2.2071E+11,"Block Group 3, Census Tract 137, Orleans Parish, Louisiana",278,63,16,24,262,68
1500000US220710137004,2.2071E+11,"Block Group 4, Census Tract 137, Orleans Parish, Louisiana",455,81,0,12,455,81
1500000US220710138001,2.2071E+11,"Block Group 1, Census Tract 138, Orleans Parish, Louisiana",245,56,0,12,245,56
1500000US220710138002,2.2071E+11,"Block Group 2, Census Tract 138, Orleans Parish, Louisiana",263,59,0,12,263,59
1500000US220710138003,2.2071E+11,"Block Group 3, Census Tract 138, Orleans Parish, Louisiana",306,64,18,20,288,65
1500000US220710139001,2.2071E+11,"Block Group 1, Census Tract 139, Orleans Parish, Louisiana",282,68,0,12,282,68
1500000US220710139002,2.2071E+11,"Block Group 2, Census Tract 139, Orleans Parish, Louisiana",590,92,0,12,590,92
1500000US220710140001,2.2071E+11,"Block Group 1, Census Tract 140, Orleans Parish, Louisiana",93,39,6,9,87,39
1500000US220710140002,2.2071E+11,"Block Group 2, Census Tract 140, Orleans Parish, Louisiana",422,74,13,18,409,74
1500000US220710140003,2.2071E+11,"Block Group 3, Census Tract 140, Orleans Parish, Louisiana",302,66,40,33,262,70
1500000US220710140004,2.2071E+11,"Block Group 4, Census Tract 140, Orleans Parish, Louisiana",50,38,0,12,50,38
1500000US220710141001,2.2071E+11,"Block Group 1, Census Tract 141, Orleans Parish, Louisiana",492,86,0,12,492,86
1500000US220710141002,2.2071E+11,"Block Group 2, Census Tract 141, Orleans Parish, Louisiana",142,69,0,12,142,69
1500000US220710141003,2.2071E+11,"Block Group 3, Census Tract 141, Orleans Parish, Louisiana",422,95,0,12,422,95
1500000US220710142001,2.2071E+11,"Block Group 1, Census Tract 142, Orleans Parish, Louisiana",204,61,4,7,200,61
1500000US220710142002,2.2071E+11,"Block Group 2, Census Tract 142, Orleans Parish, Louisiana",530,96,0,12,530,96
1500000US220710142003,2.2071E+11,"Block Group 3, Census Tract 142, Orleans Parish, Louisiana",203,73,0,12,203,73
1500000US220710143001,2.2071E+11,"Block Group 1, Census Tract 143, Orleans Parish, Louisiana",224,58,10,15,214,58
1500000US220710143002,2.2071E+11,"Block Group 2, Census Tract 143, Orleans Parish, Louisiana",76,32,3,7,73,33
1500000US220710143003,2.2071E+11,"Block Group 3, Census Tract 143, Orleans Parish, Louisiana",410,74,38,24,372,75
1500000US220710144001,2.2071E+11,"Block Group 1, Census Tract 144, Orleans Parish, Louisiana",142,47,0,12,142,47
1500000US220710144002,2.2071E+11,"Block Group 2, Census Tract 144, Orleans Parish, Louisiana",335,74,4,7,331,74
1500000US220710144003,2.2071E+11,"Block Group 3, Census Tract 144, Orleans Parish, Louisiana",330,76,6,10,324,75
1500000US220710145001,2.2071E+11,"Block Group 1, Census Tract 145, Orleans Parish, Louisiana",0,12,0,12,0,12
1500000US220719800001,2.2072E+11,"Block Group 1, Census Tract 9800, Orleans Parish, Louisiana",0,12,0,12,0,12
1500000US220719801001,2.2072E+11,"Block Group 1, Census Tract 9801, Orleans Parish, Louisiana",0,12,0,12,0,12
1500000US220719900000,2.2072E+11,"Block Group 0, Census Tract 9900, Orleans Parish, Louisiana",0,12,0,12,0,12
