Id,Id2,Geography,Estimate; Total:,Margin of Error; Total:,Estimate; Total: - Occupied,Margin of Error; Total: - Occupied,Estimate; Total: - Vacant,Margin of Error; Total: - Vacant
1500000US220710001001,2.21E+11,"Block Group 1, Census Tract 1, Orleans Parish, Louisiana",492,96,435,92,57,64
1500000US220710001002,2.21E+11,"Block Group 2, Census Tract 1, Orleans Parish, Louisiana",662,119,571,123,91,79
1500000US220710001003,2.21E+11,"Block Group 3, Census Tract 1, Orleans Parish, Louisiana",430,85,322,79,108,72
1500000US220710002001,2.21E+11,"Block Group 1, Census Tract 2, Orleans Parish, Louisiana",351,62,236,61,115,53
1500000US220710002002,2.21E+11,"Block Group 2, Census Tract 2, Orleans Parish, Louisiana",449,68,310,61,139,62
1500000US220710003001,2.21E+11,"Block Group 1, Census Tract 3, Orleans Parish, Louisiana",401,58,256,60,145,54
1500000US220710003002,2.21E+11,"Block Group 2, Census Tract 3, Orleans Parish, Louisiana",340,56,237,54,103,55
1500000US220710004001,2.21E+11,"Block Group 1, Census Tract 4, Orleans Parish, Louisiana",602,86,483,73,119,62
1500000US220710004002,2.21E+11,"Block Group 2, Census Tract 4, Orleans Parish, Louisiana",598,94,421,83,177,96
1500000US220710006011,2.21E+11,"Block Group 1, Census Tract 6.01, Orleans Parish, Louisiana",192,43,146,40,46,38
1500000US220710006012,2.21E+11,"Block Group 2, Census Tract 6.01, Orleans Parish, Louisiana",241,54,168,68,73,64
1500000US220710006021,2.21E+11,"Block Group 1, Census Tract 6.02, Orleans Parish, Louisiana",397,80,337,63,60,60
1500000US220710006022,2.21E+11,"Block Group 2, Census Tract 6.02, Orleans Parish, Louisiana",299,66,239,60,60,48
1500000US220710006023,2.21E+11,"Block Group 3, Census Tract 6.02, Orleans Parish, Louisiana",461,83,382,76,79,46
1500000US220710006031,2.21E+11,"Block Group 1, Census Tract 6.03, Orleans Parish, Louisiana",420,89,197,57,223,82
1500000US220710006032,2.21E+11,"Block Group 2, Census Tract 6.03, Orleans Parish, Louisiana",355,61,257,56,98,54
1500000US220710006041,2.21E+11,"Block Group 1, Census Tract 6.04, Orleans Parish, Louisiana",524,118,453,107,71,56
1500000US220710006042,2.21E+11,"Block Group 2, Census Tract 6.04, Orleans Parish, Louisiana",820,121,738,146,82,65
1500000US220710006043,2.21E+11,"Block Group 3, Census Tract 6.04, Orleans Parish, Louisiana",578,152,324,103,254,119
1500000US220710006051,2.21E+11,"Block Group 1, Census Tract 6.05, Orleans Parish, Louisiana",419,66,378,64,41,35
1500000US220710006052,2.21E+11,"Block Group 2, Census Tract 6.05, Orleans Parish, Louisiana",232,53,174,49,58,40
1500000US220710006053,2.21E+11,"Block Group 3, Census Tract 6.05, Orleans Parish, Louisiana",316,67,230,48,86,51
1500000US220710006061,2.21E+11,"Block Group 1, Census Tract 6.06, Orleans Parish, Louisiana",585,104,538,99,47,59
1500000US220710006062,2.21E+11,"Block Group 2, Census Tract 6.06, Orleans Parish, Louisiana",586,109,567,109,19,26
1500000US220710006063,2.21E+11,"Block Group 3, Census Tract 6.06, Orleans Parish, Louisiana",596,98,531,108,65,61
1500000US220710006071,2.21E+11,"Block Group 1, Census Tract 6.07, Orleans Parish, Louisiana",307,99,307,99,0,12
1500000US220710006072,2.21E+11,"Block Group 2, Census Tract 6.07, Orleans Parish, Louisiana",563,95,536,93,27,42
1500000US220710006073,2.21E+11,"Block Group 3, Census Tract 6.07, Orleans Parish, Louisiana",733,94,706,100,27,41
1500000US220710006111,2.21E+11,"Block Group 1, Census Tract 6.11, Orleans Parish, Louisiana",671,90,536,93,135,68
1500000US220710006112,2.21E+11,"Block Group 2, Census Tract 6.11, Orleans Parish, Louisiana",1112,104,974,106,138,58
1500000US220710006121,2.21E+11,"Block Group 1, Census Tract 6.12, Orleans Parish, Louisiana",642,48,538,68,104,71
1500000US220710006131,2.21E+11,"Block Group 1, Census Tract 6.13, Orleans Parish, Louisiana",297,85,289,86,8,17
1500000US220710006132,2.21E+11,"Block Group 2, Census Tract 6.13, Orleans Parish, Louisiana",644,130,520,132,124,71
1500000US220710006133,2.21E+11,"Block Group 3, Census Tract 6.13, Orleans Parish, Louisiana",1465,118,1243,130,222,76
1500000US220710006151,2.21E+11,"Block Group 1, Census Tract 6.15, Orleans Parish, Louisiana",657,121,621,132,36,48
1500000US220710006152,2.21E+11,"Block Group 2, Census Tract 6.15, Orleans Parish, Louisiana",1463,131,1065,173,398,159
1500000US220710006161,2.21E+11,"Block Group 1, Census Tract 6.16, Orleans Parish, Louisiana",410,111,348,101,62,58
1500000US220710006162,2.21E+11,"Block Group 2, Census Tract 6.16, Orleans Parish, Louisiana",957,124,491,150,466,149
1500000US220710006163,2.21E+11,"Block Group 3, Census Tract 6.16, Orleans Parish, Louisiana",636,126,636,126,0,12
1500000US220710006171,2.21E+11,"Block Group 1, Census Tract 6.17, Orleans Parish, Louisiana",1078,180,750,202,328,149
1500000US220710006172,2.21E+11,"Block Group 2, Census Tract 6.17, Orleans Parish, Louisiana",1302,194,1180,202,122,84
1500000US220710006181,2.21E+11,"Block Group 1, Census Tract 6.18, Orleans Parish, Louisiana",575,77,543,78,32,36
1500000US220710006182,2.21E+11,"Block Group 2, Census Tract 6.18, Orleans Parish, Louisiana",924,84,750,98,174,83
1500000US220710007011,2.21E+11,"Block Group 1, Census Tract 7.01, Orleans Parish, Louisiana",28,23,28,23,0,12
1500000US220710007012,2.21E+11,"Block Group 2, Census Tract 7.01, Orleans Parish, Louisiana",52,24,45,21,7,11
1500000US220710007013,2.21E+11,"Block Group 3, Census Tract 7.01, Orleans Parish, Louisiana",104,32,74,27,30,21
1500000US220710007014,2.21E+11,"Block Group 4, Census Tract 7.01, Orleans Parish, Louisiana",75,27,75,27,0,12
1500000US220710007021,2.21E+11,"Block Group 1, Census Tract 7.02, Orleans Parish, Louisiana",158,60,131,54,27,31
1500000US220710007022,2.21E+11,"Block Group 2, Census Tract 7.02, Orleans Parish, Louisiana",270,71,252,68,18,23
1500000US220710007023,2.21E+11,"Block Group 3, Census Tract 7.02, Orleans Parish, Louisiana",160,88,52,29,108,86
1500000US220710007024,2.21E+11,"Block Group 4, Census Tract 7.02, Orleans Parish, Louisiana",217,81,176,77,41,38
1500000US220710008001,2.21E+11,"Block Group 1, Census Tract 8, Orleans Parish, Louisiana",200,55,149,47,51,40
1500000US220710008002,2.21E+11,"Block Group 2, Census Tract 8, Orleans Parish, Louisiana",182,55,165,53,17,20
1500000US220710008003,2.21E+11,"Block Group 3, Census Tract 8, Orleans Parish, Louisiana",292,76,179,53,113,61
1500000US220710009011,2.21E+11,"Block Group 1, Census Tract 9.01, Orleans Parish, Louisiana",119,58,59,28,60,58
1500000US220710009012,2.21E+11,"Block Group 2, Census Tract 9.01, Orleans Parish, Louisiana",112,50,81,49,31,25
1500000US220710009013,2.21E+11,"Block Group 3, Census Tract 9.01, Orleans Parish, Louisiana",64,47,38,27,26,40
1500000US220710009014,2.21E+11,"Block Group 4, Census Tract 9.01, Orleans Parish, Louisiana",146,54,124,49,22,21
1500000US220710009021,2.21E+11,"Block Group 1, Census Tract 9.02, Orleans Parish, Louisiana",14,10,14,10,0,12
1500000US220710009022,2.21E+11,"Block Group 2, Census Tract 9.02, Orleans Parish, Louisiana",41,27,35,30,6,11
1500000US220710009023,2.21E+11,"Block Group 3, Census Tract 9.02, Orleans Parish, Louisiana",67,40,67,40,0,12
1500000US220710009024,2.21E+11,"Block Group 4, Census Tract 9.02, Orleans Parish, Louisiana",36,23,29,19,7,12
1500000US220710009031,2.21E+11,"Block Group 1, Census Tract 9.03, Orleans Parish, Louisiana",68,27,55,31,13,15
1500000US220710009032,2.21E+11,"Block Group 2, Census Tract 9.03, Orleans Parish, Louisiana",107,35,88,31,19,21
1500000US220710009033,2.21E+11,"Block Group 3, Census Tract 9.03, Orleans Parish, Louisiana",27,21,22,19,5,8
1500000US220710009034,2.21E+11,"Block Group 4, Census Tract 9.03, Orleans Parish, Louisiana",41,24,41,24,0,12
1500000US220710009041,2.21E+11,"Block Group 1, Census Tract 9.04, Orleans Parish, Louisiana",232,56,193,51,39,39
1500000US220710009042,2.21E+11,"Block Group 2, Census Tract 9.04, Orleans Parish, Louisiana",268,63,161,51,107,51
1500000US220710011001,2.21E+11,"Block Group 1, Census Tract 11, Orleans Parish, Louisiana",355,71,274,72,81,40
1500000US220710011002,2.21E+11,"Block Group 2, Census Tract 11, Orleans Parish, Louisiana",777,86,639,83,138,65
1500000US220710011003,2.21E+11,"Block Group 3, Census Tract 11, Orleans Parish, Louisiana",0,12,0,12,0,12
1500000US220710012001,2.21E+11,"Block Group 1, Census Tract 12, Orleans Parish, Louisiana",416,66,322,65,94,52
1500000US220710012002,2.21E+11,"Block Group 2, Census Tract 12, Orleans Parish, Louisiana",318,72,223,49,95,64
1500000US220710012003,2.21E+11,"Block Group 3, Census Tract 12, Orleans Parish, Louisiana",380,70,342,69,38,34
1500000US220710013011,2.21E+11,"Block Group 1, Census Tract 13.01, Orleans Parish, Louisiana",388,61,307,58,81,53
1500000US220710013012,2.21E+11,"Block Group 2, Census Tract 13.01, Orleans Parish, Louisiana",212,55,165,44,47,39
1500000US220710013013,2.21E+11,"Block Group 3, Census Tract 13.01, Orleans Parish, Louisiana",270,66,160,42,110,62
1500000US220710013014,2.21E+11,"Block Group 4, Census Tract 13.01, Orleans Parish, Louisiana",222,63,149,60,73,60
1500000US220710013021,2.21E+11,"Block Group 1, Census Tract 13.02, Orleans Parish, Louisiana",269,67,193,52,76,48
1500000US220710013022,2.21E+11,"Block Group 2, Census Tract 13.02, Orleans Parish, Louisiana",317,67,246,58,71,51
1500000US220710014011,2.21E+11,"Block Group 1, Census Tract 14.01, Orleans Parish, Louisiana",123,42,113,39,10,17
1500000US220710014012,2.21E+11,"Block Group 2, Census Tract 14.01, Orleans Parish, Louisiana",90,32,74,27,16,22
1500000US220710014013,2.21E+11,"Block Group 3, Census Tract 14.01, Orleans Parish, Louisiana",156,50,145,49,11,18
1500000US220710014014,2.21E+11,"Block Group 4, Census Tract 14.01, Orleans Parish, Louisiana",108,37,99,34,9,16
1500000US220710014015,2.21E+11,"Block Group 5, Census Tract 14.01, Orleans Parish, Louisiana",55,37,44,36,11,17
1500000US220710014016,2.21E+11,"Block Group 6, Census Tract 14.01, Orleans Parish, Louisiana",84,33,53,30,31,26
1500000US220710014021,2.21E+11,"Block Group 1, Census Tract 14.02, Orleans Parish, Louisiana",268,65,240,57,28,27
1500000US220710014022,2.21E+11,"Block Group 2, Census Tract 14.02, Orleans Parish, Louisiana",152,49,118,46,34,26
1500000US220710014023,2.21E+11,"Block Group 3, Census Tract 14.02, Orleans Parish, Louisiana",145,54,136,53,9,14
1500000US220710014024,2.21E+11,"Block Group 4, Census Tract 14.02, Orleans Parish, Louisiana",386,69,265,56,121,52
1500000US220710015001,2.21E+11,"Block Group 1, Census Tract 15, Orleans Parish, Louisiana",293,54,219,53,74,36
1500000US220710015002,2.21E+11,"Block Group 2, Census Tract 15, Orleans Parish, Louisiana",221,44,141,40,80,41
1500000US220710016001,2.21E+11,"Block Group 1, Census Tract 16, Orleans Parish, Louisiana",0,12,0,12,0,12
1500000US220710017011,2.21E+11,"Block Group 1, Census Tract 17.01, Orleans Parish, Louisiana",281,57,229,48,52,50
1500000US220710017012,2.21E+11,"Block Group 2, Census Tract 17.01, Orleans Parish, Louisiana",155,39,155,39,0,12
1500000US220710017013,2.21E+11,"Block Group 3, Census Tract 17.01, Orleans Parish, Louisiana",280,65,180,42,100,75
1500000US220710017021,2.21E+11,"Block Group 1, Census Tract 17.02, Orleans Parish, Louisiana",382,74,313,65,69,46
1500000US220710017022,2.21E+11,"Block Group 2, Census Tract 17.02, Orleans Parish, Louisiana",412,72,306,65,106,59
1500000US220710017023,2.21E+11,"Block Group 3, Census Tract 17.02, Orleans Parish, Louisiana",171,56,154,46,17,26
1500000US220710017024,2.21E+11,"Block Group 4, Census Tract 17.02, Orleans Parish, Louisiana",221,51,150,49,71,53
1500000US220710017201,2.21E+11,"Block Group 1, Census Tract 17.20, Orleans Parish, Louisiana",235,71,192,64,43,48
1500000US220710017202,2.21E+11,"Block Group 2, Census Tract 17.20, Orleans Parish, Louisiana",412,84,235,74,177,85
1500000US220710017203,2.21E+11,"Block Group 3, Census Tract 17.20, Orleans Parish, Louisiana",638,106,445,93,193,80
1500000US220710017204,2.21E+11,"Block Group 4, Census Tract 17.20, Orleans Parish, Louisiana",446,112,321,95,125,69
1500000US220710017221,2.21E+11,"Block Group 1, Census Tract 17.22, Orleans Parish, Louisiana",261,87,167,82,94,64
1500000US220710017222,2.21E+11,"Block Group 2, Census Tract 17.22, Orleans Parish, Louisiana",297,88,253,81,44,42
1500000US220710017223,2.21E+11,"Block Group 3, Census Tract 17.22, Orleans Parish, Louisiana",498,79,431,80,67,41
1500000US220710017224,2.21E+11,"Block Group 4, Census Tract 17.22, Orleans Parish, Louisiana",172,54,172,54,0,12
1500000US220710017225,2.21E+11,"Block Group 5, Census Tract 17.22, Orleans Parish, Louisiana",400,88,349,80,51,48
1500000US220710017226,2.21E+11,"Block Group 6, Census Tract 17.22, Orleans Parish, Louisiana",199,73,123,62,76,56
1500000US220710017227,2.21E+11,"Block Group 7, Census Tract 17.22, Orleans Parish, Louisiana",135,63,121,66,14,24
1500000US220710017231,2.21E+11,"Block Group 1, Census Tract 17.23, Orleans Parish, Louisiana",322,89,272,82,50,39
1500000US220710017232,2.21E+11,"Block Group 2, Census Tract 17.23, Orleans Parish, Louisiana",815,109,738,108,77,54
1500000US220710017233,2.21E+11,"Block Group 3, Census Tract 17.23, Orleans Parish, Louisiana",407,84,331,89,76,54
1500000US220710017234,2.21E+11,"Block Group 4, Census Tract 17.23, Orleans Parish, Louisiana",560,105,508,102,52,39
1500000US220710017241,2.21E+11,"Block Group 1, Census Tract 17.24, Orleans Parish, Louisiana",433,109,268,83,165,98
1500000US220710017242,2.21E+11,"Block Group 2, Census Tract 17.24, Orleans Parish, Louisiana",427,100,356,90,71,49
1500000US220710017243,2.21E+11,"Block Group 3, Census Tract 17.24, Orleans Parish, Louisiana",744,128,612,118,132,71
1500000US220710017244,2.21E+11,"Block Group 4, Census Tract 17.24, Orleans Parish, Louisiana",588,125,426,119,162,97
1500000US220710017251,2.21E+11,"Block Group 1, Census Tract 17.25, Orleans Parish, Louisiana",820,166,765,156,55,70
1500000US220710017252,2.21E+11,"Block Group 2, Census Tract 17.25, Orleans Parish, Louisiana",632,139,559,129,73,77
1500000US220710017253,2.21E+11,"Block Group 3, Census Tract 17.25, Orleans Parish, Louisiana",591,138,521,127,70,77
1500000US220710017254,2.21E+11,"Block Group 4, Census Tract 17.25, Orleans Parish, Louisiana",771,154,569,139,202,119
1500000US220710017301,2.21E+11,"Block Group 1, Census Tract 17.30, Orleans Parish, Louisiana",378,43,287,46,91,44
1500000US220710017341,2.21E+11,"Block Group 1, Census Tract 17.34, Orleans Parish, Louisiana",603,57,333,70,270,86
1500000US220710017351,2.21E+11,"Block Group 1, Census Tract 17.35, Orleans Parish, Louisiana",673,94,454,85,219,68
1500000US220710017352,2.21E+11,"Block Group 2, Census Tract 17.35, Orleans Parish, Louisiana",546,80,350,67,196,68
1500000US220710017361,2.21E+11,"Block Group 1, Census Tract 17.36, Orleans Parish, Louisiana",416,84,241,69,175,73
1500000US220710017362,2.21E+11,"Block Group 2, Census Tract 17.36, Orleans Parish, Louisiana",620,79,559,82,61,35
1500000US220710017371,2.21E+11,"Block Group 1, Census Tract 17.37, Orleans Parish, Louisiana",899,95,724,112,175,84
1500000US220710017372,2.21E+11,"Block Group 2, Census Tract 17.37, Orleans Parish, Louisiana",364,70,322,66,42,39
1500000US220710017373,2.21E+11,"Block Group 3, Census Tract 17.37, Orleans Parish, Louisiana",325,65,249,63,76,53
1500000US220710017391,2.21E+11,"Block Group 1, Census Tract 17.39, Orleans Parish, Louisiana",504,65,408,67,96,55
1500000US220710017392,2.21E+11,"Block Group 2, Census Tract 17.39, Orleans Parish, Louisiana",194,46,165,43,29,26
1500000US220710017401,2.21E+11,"Block Group 1, Census Tract 17.40, Orleans Parish, Louisiana",486,88,442,93,44,40
1500000US220710017402,2.21E+11,"Block Group 2, Census Tract 17.40, Orleans Parish, Louisiana",937,123,695,128,242,103
1500000US220710017403,2.21E+11,"Block Group 3, Census Tract 17.40, Orleans Parish, Louisiana",825,128,656,127,169,86
1500000US220710017411,2.21E+11,"Block Group 1, Census Tract 17.41, Orleans Parish, Louisiana",546,25,480,44,66,37
1500000US220710017431,2.21E+11,"Block Group 1, Census Tract 17.43, Orleans Parish, Louisiana",713,98,625,105,88,61
1500000US220710017432,2.21E+11,"Block Group 2, Census Tract 17.43, Orleans Parish, Louisiana",554,109,314,101,240,82
1500000US220710017441,2.21E+11,"Block Group 1, Census Tract 17.44, Orleans Parish, Louisiana",610,88,489,106,121,70
1500000US220710017442,2.21E+11,"Block Group 2, Census Tract 17.44, Orleans Parish, Louisiana",664,113,493,139,171,95
1500000US220710017443,2.21E+11,"Block Group 3, Census Tract 17.44, Orleans Parish, Louisiana",427,97,427,97,0,12
1500000US220710017451,2.21E+11,"Block Group 1, Census Tract 17.45, Orleans Parish, Louisiana",1057,94,930,106,127,79
1500000US220710017452,2.21E+11,"Block Group 2, Census Tract 17.45, Orleans Parish, Louisiana",441,81,409,79,32,36
1500000US220710017461,2.21E+11,"Block Group 1, Census Tract 17.46, Orleans Parish, Louisiana",563,116,482,126,81,70
1500000US220710017462,2.21E+11,"Block Group 2, Census Tract 17.46, Orleans Parish, Louisiana",604,115,578,116,26,43
1500000US220710017463,2.21E+11,"Block Group 3, Census Tract 17.46, Orleans Parish, Louisiana",713,134,563,131,150,85
1500000US220710017471,2.21E+11,"Block Group 1, Census Tract 17.47, Orleans Parish, Louisiana",957,97,847,104,110,71
1500000US220710017472,2.21E+11,"Block Group 2, Census Tract 17.47, Orleans Parish, Louisiana",564,93,425,90,139,73
1500000US220710017481,2.21E+11,"Block Group 1, Census Tract 17.48, Orleans Parish, Louisiana",400,91,374,84,26,40
1500000US220710017482,2.21E+11,"Block Group 2, Census Tract 17.48, Orleans Parish, Louisiana",441,100,409,98,32,36
1500000US220710017483,2.21E+11,"Block Group 3, Census Tract 17.48, Orleans Parish, Louisiana",552,98,445,101,107,67
1500000US220710017484,2.21E+11,"Block Group 4, Census Tract 17.48, Orleans Parish, Louisiana",345,79,273,88,72,65
1500000US220710017491,2.21E+11,"Block Group 1, Census Tract 17.49, Orleans Parish, Louisiana",369,69,369,69,0,12
1500000US220710017492,2.21E+11,"Block Group 2, Census Tract 17.49, Orleans Parish, Louisiana",612,69,471,78,141,60
1500000US220710017501,2.21E+11,"Block Group 1, Census Tract 17.50, Orleans Parish, Louisiana",495,93,397,89,98,53
1500000US220710017502,2.21E+11,"Block Group 2, Census Tract 17.50, Orleans Parish, Louisiana",601,107,322,87,279,79
1500000US220710017503,2.21E+11,"Block Group 3, Census Tract 17.50, Orleans Parish, Louisiana",476,79,434,93,42,49
1500000US220710017511,2.21E+11,"Block Group 1, Census Tract 17.51, Orleans Parish, Louisiana",401,48,268,45,133,50
1500000US220710018001,2.21E+11,"Block Group 1, Census Tract 18, Orleans Parish, Louisiana",555,77,418,75,137,71
1500000US220710018002,2.21E+11,"Block Group 2, Census Tract 18, Orleans Parish, Louisiana",347,79,282,65,65,65
1500000US220710019001,2.21E+11,"Block Group 1, Census Tract 19, Orleans Parish, Louisiana",231,70,138,51,93,54
1500000US220710019002,2.21E+11,"Block Group 2, Census Tract 19, Orleans Parish, Louisiana",361,59,261,58,100,51
1500000US220710019003,2.21E+11,"Block Group 3, Census Tract 19, Orleans Parish, Louisiana",307,72,245,70,62,38
1500000US220710020001,2.21E+11,"Block Group 1, Census Tract 20, Orleans Parish, Louisiana",271,72,212,63,59,43
1500000US220710020002,2.21E+11,"Block Group 2, Census Tract 20, Orleans Parish, Louisiana",253,71,197,65,56,35
1500000US220710020003,2.21E+11,"Block Group 3, Census Tract 20, Orleans Parish, Louisiana",131,63,107,46,24,38
1500000US220710021001,2.21E+11,"Block Group 1, Census Tract 21, Orleans Parish, Louisiana",208,60,158,57,50,32
1500000US220710021002,2.21E+11,"Block Group 2, Census Tract 21, Orleans Parish, Louisiana",270,54,209,47,61,47
1500000US220710022001,2.21E+11,"Block Group 1, Census Tract 22, Orleans Parish, Louisiana",159,53,125,44,34,34
1500000US220710022002,2.21E+11,"Block Group 2, Census Tract 22, Orleans Parish, Louisiana",226,53,181,43,45,37
1500000US220710022003,2.21E+11,"Block Group 3, Census Tract 22, Orleans Parish, Louisiana",188,56,96,44,92,50
1500000US220710023001,2.21E+11,"Block Group 1, Census Tract 23, Orleans Parish, Louisiana",84,38,59,27,25,27
1500000US220710023002,2.21E+11,"Block Group 2, Census Tract 23, Orleans Parish, Louisiana",150,53,114,56,36,34
1500000US220710023003,2.21E+11,"Block Group 3, Census Tract 23, Orleans Parish, Louisiana",100,50,68,45,32,24
1500000US220710023004,2.21E+11,"Block Group 4, Census Tract 23, Orleans Parish, Louisiana",125,48,101,42,24,27
1500000US220710023005,2.21E+11,"Block Group 5, Census Tract 23, Orleans Parish, Louisiana",627,86,475,88,152,71
1500000US220710024011,2.21E+11,"Block Group 1, Census Tract 24.01, Orleans Parish, Louisiana",481,77,414,75,67,49
1500000US220710024012,2.21E+11,"Block Group 2, Census Tract 24.01, Orleans Parish, Louisiana",457,79,355,78,102,73
1500000US220710024021,2.21E+11,"Block Group 1, Census Tract 24.02, Orleans Parish, Louisiana",232,69,168,68,64,47
1500000US220710024022,2.21E+11,"Block Group 2, Census Tract 24.02, Orleans Parish, Louisiana",546,122,355,110,191,90
1500000US220710024023,2.21E+11,"Block Group 3, Census Tract 24.02, Orleans Parish, Louisiana",344,83,276,84,68,60
1500000US220710024024,2.21E+11,"Block Group 4, Census Tract 24.02, Orleans Parish, Louisiana",512,92,419,83,93,73
1500000US220710025011,2.21E+11,"Block Group 1, Census Tract 25.01, Orleans Parish, Louisiana",343,68,278,64,65,52
1500000US220710025012,2.21E+11,"Block Group 2, Census Tract 25.01, Orleans Parish, Louisiana",205,55,161,52,44,39
1500000US220710025013,2.21E+11,"Block Group 3, Census Tract 25.01, Orleans Parish, Louisiana",165,48,105,41,60,46
1500000US220710025014,2.21E+11,"Block Group 4, Census Tract 25.01, Orleans Parish, Louisiana",187,52,130,37,57,33
1500000US220710025021,2.21E+11,"Block Group 1, Census Tract 25.02, Orleans Parish, Louisiana",383,75,320,67,63,42
1500000US220710025022,2.21E+11,"Block Group 2, Census Tract 25.02, Orleans Parish, Louisiana",271,59,179,56,92,51
1500000US220710025023,2.21E+11,"Block Group 3, Census Tract 25.02, Orleans Parish, Louisiana",206,59,142,52,64,39
1500000US220710025024,2.21E+11,"Block Group 4, Census Tract 25.02, Orleans Parish, Louisiana",189,45,171,48,18,20
1500000US220710025031,2.21E+11,"Block Group 1, Census Tract 25.03, Orleans Parish, Louisiana",216,64,150,45,66,56
1500000US220710025032,2.21E+11,"Block Group 2, Census Tract 25.03, Orleans Parish, Louisiana",395,83,377,82,18,29
1500000US220710025033,2.21E+11,"Block Group 3, Census Tract 25.03, Orleans Parish, Louisiana",286,62,281,63,5,10
1500000US220710025041,2.21E+11,"Block Group 1, Census Tract 25.04, Orleans Parish, Louisiana",281,66,191,57,90,51
1500000US220710025042,2.21E+11,"Block Group 2, Census Tract 25.04, Orleans Parish, Louisiana",391,64,328,59,63,46
1500000US220710025043,2.21E+11,"Block Group 3, Census Tract 25.04, Orleans Parish, Louisiana",204,48,181,46,23,25
1500000US220710025044,2.21E+11,"Block Group 4, Census Tract 25.04, Orleans Parish, Louisiana",312,66,229,53,83,53
1500000US220710026001,2.21E+11,"Block Group 1, Census Tract 26, Orleans Parish, Louisiana",550,88,450,92,100,75
1500000US220710026002,2.21E+11,"Block Group 2, Census Tract 26, Orleans Parish, Louisiana",756,116,528,108,228,107
1500000US220710027001,2.21E+11,"Block Group 1, Census Tract 27, Orleans Parish, Louisiana",414,85,205,60,209,77
1500000US220710027002,2.21E+11,"Block Group 2, Census Tract 27, Orleans Parish, Louisiana",299,68,261,69,38,29
1500000US220710027003,2.21E+11,"Block Group 3, Census Tract 27, Orleans Parish, Louisiana",235,62,149,54,86,44
1500000US220710028001,2.21E+11,"Block Group 1, Census Tract 28, Orleans Parish, Louisiana",260,52,170,43,90,45
1500000US220710028002,2.21E+11,"Block Group 2, Census Tract 28, Orleans Parish, Louisiana",429,76,269,62,160,60
1500000US220710028003,2.21E+11,"Block Group 3, Census Tract 28, Orleans Parish, Louisiana",229,61,202,61,27,24
1500000US220710029001,2.21E+11,"Block Group 1, Census Tract 29, Orleans Parish, Louisiana",215,63,209,64,6,8
1500000US220710029002,2.21E+11,"Block Group 2, Census Tract 29, Orleans Parish, Louisiana",239,68,147,61,92,54
1500000US220710029003,2.21E+11,"Block Group 3, Census Tract 29, Orleans Parish, Louisiana",318,86,208,84,110,56
1500000US220710030001,2.21E+11,"Block Group 1, Census Tract 30, Orleans Parish, Louisiana",382,70,213,58,169,63
1500000US220710030002,2.21E+11,"Block Group 2, Census Tract 30, Orleans Parish, Louisiana",396,78,268,65,128,53
1500000US220710031001,2.21E+11,"Block Group 1, Census Tract 31, Orleans Parish, Louisiana",202,75,147,67,55,38
1500000US220710031002,2.21E+11,"Block Group 2, Census Tract 31, Orleans Parish, Louisiana",503,78,303,75,200,80
1500000US220710033011,2.21E+11,"Block Group 1, Census Tract 33.01, Orleans Parish, Louisiana",429,65,300,57,129,81
1500000US220710033012,2.21E+11,"Block Group 2, Census Tract 33.01, Orleans Parish, Louisiana",325,83,252,72,73,49
1500000US220710033013,2.21E+11,"Block Group 3, Census Tract 33.01, Orleans Parish, Louisiana",211,59,129,39,82,47
1500000US220710033021,2.21E+11,"Block Group 1, Census Tract 33.02, Orleans Parish, Louisiana",231,70,231,70,0,12
1500000US220710033022,2.21E+11,"Block Group 2, Census Tract 33.02, Orleans Parish, Louisiana",514,81,398,78,116,65
1500000US220710033023,2.21E+11,"Block Group 3, Census Tract 33.02, Orleans Parish, Louisiana",470,80,371,79,99,66
1500000US220710033024,2.21E+11,"Block Group 4, Census Tract 33.02, Orleans Parish, Louisiana",241,65,214,64,27,30
1500000US220710033031,2.21E+11,"Block Group 1, Census Tract 33.03, Orleans Parish, Louisiana",409,78,356,70,53,50
1500000US220710033032,2.21E+11,"Block Group 2, Census Tract 33.03, Orleans Parish, Louisiana",399,80,307,81,92,59
1500000US220710033033,2.21E+11,"Block Group 3, Census Tract 33.03, Orleans Parish, Louisiana",203,56,176,52,27,30
1500000US220710033041,2.21E+11,"Block Group 1, Census Tract 33.04, Orleans Parish, Louisiana",466,69,392,64,74,41
1500000US220710033042,2.21E+11,"Block Group 2, Census Tract 33.04, Orleans Parish, Louisiana",473,62,373,60,100,54
1500000US220710033071,2.21E+11,"Block Group 1, Census Tract 33.07, Orleans Parish, Louisiana",477,55,334,66,143,66
1500000US220710033072,2.21E+11,"Block Group 2, Census Tract 33.07, Orleans Parish, Louisiana",258,50,231,47,27,26
1500000US220710033081,2.21E+11,"Block Group 1, Census Tract 33.08, Orleans Parish, Louisiana",239,71,131,54,108,56
1500000US220710033082,2.21E+11,"Block Group 2, Census Tract 33.08, Orleans Parish, Louisiana",344,75,269,75,75,58
1500000US220710033083,2.21E+11,"Block Group 3, Census Tract 33.08, Orleans Parish, Louisiana",640,101,500,89,140,79
1500000US220710033084,2.21E+11,"Block Group 4, Census Tract 33.08, Orleans Parish, Louisiana",256,73,215,63,41,47
1500000US220710033085,2.21E+11,"Block Group 5, Census Tract 33.08, Orleans Parish, Louisiana",243,69,199,66,44,30
1500000US220710033086,2.21E+11,"Block Group 6, Census Tract 33.08, Orleans Parish, Louisiana",101,52,47,32,54,39
1500000US220710034001,2.21E+11,"Block Group 1, Census Tract 34, Orleans Parish, Louisiana",390,65,276,63,114,51
1500000US220710034002,2.21E+11,"Block Group 2, Census Tract 34, Orleans Parish, Louisiana",538,68,408,79,130,55
1500000US220710035001,2.21E+11,"Block Group 1, Census Tract 35, Orleans Parish, Louisiana",300,59,237,54,63,35
1500000US220710035002,2.21E+11,"Block Group 2, Census Tract 35, Orleans Parish, Louisiana",277,61,165,56,112,46
1500000US220710035003,2.21E+11,"Block Group 3, Census Tract 35, Orleans Parish, Louisiana",275,58,218,55,57,38
1500000US220710036001,2.21E+11,"Block Group 1, Census Tract 36, Orleans Parish, Louisiana",247,44,210,47,37,27
1500000US220710036002,2.21E+11,"Block Group 2, Census Tract 36, Orleans Parish, Louisiana",474,58,395,55,79,39
1500000US220710036003,2.21E+11,"Block Group 3, Census Tract 36, Orleans Parish, Louisiana",270,60,208,59,62,36
1500000US220710037011,2.21E+11,"Block Group 1, Census Tract 37.01, Orleans Parish, Louisiana",886,81,782,91,104,63
1500000US220710037012,2.21E+11,"Block Group 2, Census Tract 37.01, Orleans Parish, Louisiana",248,58,248,58,0,12
1500000US220710037021,2.21E+11,"Block Group 1, Census Tract 37.02, Orleans Parish, Louisiana",435,103,320,98,115,66
1500000US220710037022,2.21E+11,"Block Group 2, Census Tract 37.02, Orleans Parish, Louisiana",380,104,293,89,87,74
1500000US220710037023,2.21E+11,"Block Group 3, Census Tract 37.02, Orleans Parish, Louisiana",222,68,179,68,43,40
1500000US220710037024,2.21E+11,"Block Group 4, Census Tract 37.02, Orleans Parish, Louisiana",309,85,255,77,54,50
1500000US220710037025,2.21E+11,"Block Group 5, Census Tract 37.02, Orleans Parish, Louisiana",293,79,228,79,65,57
1500000US220710037026,2.21E+11,"Block Group 6, Census Tract 37.02, Orleans Parish, Louisiana",491,108,380,101,111,69
1500000US220710038001,2.21E+11,"Block Group 1, Census Tract 38, Orleans Parish, Louisiana",735,118,437,101,298,100
1500000US220710038002,2.21E+11,"Block Group 2, Census Tract 38, Orleans Parish, Louisiana",935,121,420,104,515,143
1500000US220710039001,2.21E+11,"Block Group 1, Census Tract 39, Orleans Parish, Louisiana",464,59,303,54,161,52
1500000US220710039002,2.21E+11,"Block Group 2, Census Tract 39, Orleans Parish, Louisiana",492,63,362,71,130,53
1500000US220710040001,2.21E+11,"Block Group 1, Census Tract 40, Orleans Parish, Louisiana",579,92,393,108,186,84
1500000US220710040002,2.21E+11,"Block Group 2, Census Tract 40, Orleans Parish, Louisiana",665,92,528,104,137,59
1500000US220710041001,2.21E+11,"Block Group 1, Census Tract 41, Orleans Parish, Louisiana",545,63,437,77,108,44
1500000US220710041002,2.21E+11,"Block Group 2, Census Tract 41, Orleans Parish, Louisiana",372,62,352,58,20,27
1500000US220710044011,2.21E+11,"Block Group 1, Census Tract 44.01, Orleans Parish, Louisiana",315,70,179,62,136,59
1500000US220710044012,2.21E+11,"Block Group 2, Census Tract 44.01, Orleans Parish, Louisiana",271,65,153,58,118,45
1500000US220710044013,2.21E+11,"Block Group 3, Census Tract 44.01, Orleans Parish, Louisiana",351,76,227,62,124,53
1500000US220710044021,2.21E+11,"Block Group 1, Census Tract 44.02, Orleans Parish, Louisiana",37,62,37,62,0,12
1500000US220710044022,2.21E+11,"Block Group 2, Census Tract 44.02, Orleans Parish, Louisiana",0,12,0,12,0,12
1500000US220710045001,2.21E+11,"Block Group 1, Census Tract 45, Orleans Parish, Louisiana",307,65,225,68,82,49
1500000US220710045002,2.21E+11,"Block Group 2, Census Tract 45, Orleans Parish, Louisiana",533,78,338,75,195,68
1500000US220710045003,2.21E+11,"Block Group 3, Census Tract 45, Orleans Parish, Louisiana",586,80,479,95,107,59
1500000US220710046001,2.21E+11,"Block Group 1, Census Tract 46, Orleans Parish, Louisiana",291,69,269,68,22,35
1500000US220710046002,2.21E+11,"Block Group 2, Census Tract 46, Orleans Parish, Louisiana",892,98,804,94,88,63
1500000US220710046003,2.21E+11,"Block Group 3, Census Tract 46, Orleans Parish, Louisiana",491,93,428,89,63,57
1500000US220710048001,2.21E+11,"Block Group 1, Census Tract 48, Orleans Parish, Louisiana",702,88,376,94,326,80
1500000US220710049001,2.21E+11,"Block Group 1, Census Tract 49, Orleans Parish, Louisiana",384,72,296,77,88,42
1500000US220710049002,2.21E+11,"Block Group 2, Census Tract 49, Orleans Parish, Louisiana",441,81,234,64,207,75
1500000US220710049003,2.21E+11,"Block Group 3, Census Tract 49, Orleans Parish, Louisiana",56,52,12,19,44,49
1500000US220710049004,2.21E+11,"Block Group 4, Census Tract 49, Orleans Parish, Louisiana",152,47,119,43,33,30
1500000US220710050001,2.21E+11,"Block Group 1, Census Tract 50, Orleans Parish, Louisiana",358,55,302,57,56,31
1500000US220710050002,2.21E+11,"Block Group 2, Census Tract 50, Orleans Parish, Louisiana",361,59,303,59,58,36
1500000US220710054001,2.21E+11,"Block Group 1, Census Tract 54, Orleans Parish, Louisiana",355,90,329,89,26,41
1500000US220710054002,2.21E+11,"Block Group 2, Census Tract 54, Orleans Parish, Louisiana",492,115,324,99,168,83
1500000US220710054003,2.21E+11,"Block Group 3, Census Tract 54, Orleans Parish, Louisiana",441,88,350,83,91,64
1500000US220710055001,2.21E+11,"Block Group 1, Census Tract 55, Orleans Parish, Louisiana",473,74,437,74,36,33
1500000US220710055002,2.21E+11,"Block Group 2, Census Tract 55, Orleans Parish, Louisiana",514,86,401,74,113,67
1500000US220710055003,2.21E+11,"Block Group 3, Census Tract 55, Orleans Parish, Louisiana",396,78,370,74,26,41
1500000US220710056011,2.21E+11,"Block Group 1, Census Tract 56.01, Orleans Parish, Louisiana",313,63,257,62,56,39
1500000US220710056012,2.21E+11,"Block Group 2, Census Tract 56.01, Orleans Parish, Louisiana",280,55,252,55,28,26
1500000US220710056013,2.21E+11,"Block Group 3, Census Tract 56.01, Orleans Parish, Louisiana",224,37,176,33,48,30
1500000US220710056014,2.21E+11,"Block Group 4, Census Tract 56.01, Orleans Parish, Louisiana",238,44,191,37,47,31
1500000US220710056021,2.21E+11,"Block Group 1, Census Tract 56.02, Orleans Parish, Louisiana",186,56,156,39,30,46
1500000US220710056022,2.21E+11,"Block Group 2, Census Tract 56.02, Orleans Parish, Louisiana",367,64,327,51,40,48
1500000US220710056023,2.21E+11,"Block Group 3, Census Tract 56.02, Orleans Parish, Louisiana",295,56,295,56,0,12
1500000US220710056024,2.21E+11,"Block Group 4, Census Tract 56.02, Orleans Parish, Louisiana",191,56,173,55,18,27
1500000US220710056031,2.21E+11,"Block Group 1, Census Tract 56.03, Orleans Parish, Louisiana",270,60,215,44,55,49
1500000US220710056032,2.21E+11,"Block Group 2, Census Tract 56.03, Orleans Parish, Louisiana",270,52,228,48,42,41
1500000US220710056033,2.21E+11,"Block Group 3, Census Tract 56.03, Orleans Parish, Louisiana",180,43,168,44,12,20
1500000US220710056041,2.21E+11,"Block Group 1, Census Tract 56.04, Orleans Parish, Louisiana",195,57,195,57,0,12
1500000US220710056042,2.21E+11,"Block Group 2, Census Tract 56.04, Orleans Parish, Louisiana",268,56,229,44,39,49
1500000US220710056043,2.21E+11,"Block Group 3, Census Tract 56.04, Orleans Parish, Louisiana",211,41,174,39,37,40
1500000US220710060001,2.21E+11,"Block Group 1, Census Tract 60, Orleans Parish, Louisiana",678,52,584,66,94,44
1500000US220710063001,2.21E+11,"Block Group 1, Census Tract 63, Orleans Parish, Louisiana",430,70,363,68,67,46
1500000US220710063002,2.21E+11,"Block Group 2, Census Tract 63, Orleans Parish, Louisiana",144,50,77,40,67,37
1500000US220710063003,2.21E+11,"Block Group 3, Census Tract 63, Orleans Parish, Louisiana",341,66,229,61,112,57
1500000US220710064001,2.21E+11,"Block Group 1, Census Tract 64, Orleans Parish, Louisiana",368,62,253,60,115,52
1500000US220710064002,2.21E+11,"Block Group 2, Census Tract 64, Orleans Parish, Louisiana",427,82,331,78,96,54
1500000US220710064003,2.21E+11,"Block Group 3, Census Tract 64, Orleans Parish, Louisiana",259,65,202,63,57,47
1500000US220710064004,2.21E+11,"Block Group 4, Census Tract 64, Orleans Parish, Louisiana",403,76,242,60,161,71
1500000US220710065001,2.21E+11,"Block Group 1, Census Tract 65, Orleans Parish, Louisiana",461,74,418,75,43,39
1500000US220710065002,2.21E+11,"Block Group 2, Census Tract 65, Orleans Parish, Louisiana",428,70,375,68,53,40
1500000US220710065003,2.21E+11,"Block Group 3, Census Tract 65, Orleans Parish, Louisiana",530,87,391,76,139,65
1500000US220710069001,2.21E+11,"Block Group 1, Census Tract 69, Orleans Parish, Louisiana",132,37,103,37,29,24
1500000US220710069002,2.21E+11,"Block Group 2, Census Tract 69, Orleans Parish, Louisiana",36,32,19,17,17,28
1500000US220710069003,2.21E+11,"Block Group 3, Census Tract 69, Orleans Parish, Louisiana",260,43,153,40,107,38
1500000US220710070001,2.21E+11,"Block Group 1, Census Tract 70, Orleans Parish, Louisiana",90,45,70,44,20,21
1500000US220710070002,2.21E+11,"Block Group 2, Census Tract 70, Orleans Parish, Louisiana",194,51,136,38,58,34
1500000US220710071011,2.21E+11,"Block Group 1, Census Tract 71.01, Orleans Parish, Louisiana",402,66,329,63,73,32
1500000US220710071012,2.21E+11,"Block Group 2, Census Tract 71.01, Orleans Parish, Louisiana",1005,69,790,88,215,78
1500000US220710072001,2.21E+11,"Block Group 1, Census Tract 72, Orleans Parish, Louisiana",710,82,630,88,80,41
1500000US220710072002,2.21E+11,"Block Group 2, Census Tract 72, Orleans Parish, Louisiana",348,77,278,81,70,41
1500000US220710072003,2.21E+11,"Block Group 3, Census Tract 72, Orleans Parish, Louisiana",189,65,119,48,70,50
1500000US220710075011,2.21E+11,"Block Group 1, Census Tract 75.01, Orleans Parish, Louisiana",219,70,206,70,13,21
1500000US220710075012,2.21E+11,"Block Group 2, Census Tract 75.01, Orleans Parish, Louisiana",316,72,220,64,96,58
1500000US220710075013,2.21E+11,"Block Group 3, Census Tract 75.01, Orleans Parish, Louisiana",314,68,217,69,97,65
1500000US220710075014,2.21E+11,"Block Group 4, Census Tract 75.01, Orleans Parish, Louisiana",217,64,188,66,29,34
1500000US220710075015,2.21E+11,"Block Group 5, Census Tract 75.01, Orleans Parish, Louisiana",213,70,139,66,74,43
1500000US220710075021,2.21E+11,"Block Group 1, Census Tract 75.02, Orleans Parish, Louisiana",161,69,116,61,45,36
1500000US220710075022,2.21E+11,"Block Group 2, Census Tract 75.02, Orleans Parish, Louisiana",268,79,131,65,137,78
1500000US220710075023,2.21E+11,"Block Group 3, Census Tract 75.02, Orleans Parish, Louisiana",326,60,311,64,15,25
1500000US220710075024,2.21E+11,"Block Group 4, Census Tract 75.02, Orleans Parish, Louisiana",329,84,162,70,167,75
1500000US220710075025,2.21E+11,"Block Group 5, Census Tract 75.02, Orleans Parish, Louisiana",442,87,287,84,155,73
1500000US220710076041,2.21E+11,"Block Group 1, Census Tract 76.04, Orleans Parish, Louisiana",426,60,369,63,57,39
1500000US220710076042,2.21E+11,"Block Group 2, Census Tract 76.04, Orleans Parish, Louisiana",301,47,286,40,15,25
1500000US220710076051,2.21E+11,"Block Group 1, Census Tract 76.05, Orleans Parish, Louisiana",338,53,275,52,63,35
1500000US220710076052,2.21E+11,"Block Group 2, Census Tract 76.05, Orleans Parish, Louisiana",422,52,334,48,88,40
1500000US220710076061,2.21E+11,"Block Group 1, Census Tract 76.06, Orleans Parish, Louisiana",1034,111,761,102,273,91
1500000US220710076062,2.21E+11,"Block Group 2, Census Tract 76.06, Orleans Parish, Louisiana",462,84,432,83,30,35
1500000US220710076063,2.21E+11,"Block Group 3, Census Tract 76.06, Orleans Parish, Louisiana",689,84,636,93,53,48
1500000US220710077001,2.21E+11,"Block Group 1, Census Tract 77, Orleans Parish, Louisiana",1327,129,877,121,450,119
1500000US220710077002,2.21E+11,"Block Group 2, Census Tract 77, Orleans Parish, Louisiana",1059,133,751,119,308,106
1500000US220710078001,2.21E+11,"Block Group 1, Census Tract 78, Orleans Parish, Louisiana",786,51,671,73,115,55
1500000US220710082001,2.21E+11,"Block Group 1, Census Tract 82, Orleans Parish, Louisiana",642,92,454,94,188,76
1500000US220710082002,2.21E+11,"Block Group 2, Census Tract 82, Orleans Parish, Louisiana",576,105,482,105,94,63
1500000US220710083001,2.21E+11,"Block Group 1, Census Tract 83, Orleans Parish, Louisiana",436,65,321,52,115,57
1500000US220710083002,2.21E+11,"Block Group 2, Census Tract 83, Orleans Parish, Louisiana",278,62,232,55,46,49
1500000US220710084001,2.21E+11,"Block Group 1, Census Tract 84, Orleans Parish, Louisiana",414,76,336,72,78,42
1500000US220710084002,2.21E+11,"Block Group 2, Census Tract 84, Orleans Parish, Louisiana",510,69,358,67,152,54
1500000US220710085001,2.21E+11,"Block Group 1, Census Tract 85, Orleans Parish, Louisiana",476,95,330,97,146,75
1500000US220710085002,2.21E+11,"Block Group 2, Census Tract 85, Orleans Parish, Louisiana",331,89,245,84,86,52
1500000US220710086001,2.21E+11,"Block Group 1, Census Tract 86, Orleans Parish, Louisiana",340,66,216,49,124,49
1500000US220710086002,2.21E+11,"Block Group 2, Census Tract 86, Orleans Parish, Louisiana",251,51,199,47,52,36
1500000US220710088001,2.21E+11,"Block Group 1, Census Tract 88, Orleans Parish, Louisiana",460,92,411,85,49,52
1500000US220710088002,2.21E+11,"Block Group 2, Census Tract 88, Orleans Parish, Louisiana",497,88,456,82,41,34
1500000US220710090001,2.21E+11,"Block Group 1, Census Tract 90, Orleans Parish, Louisiana",386,105,305,75,81,95
1500000US220710090002,2.21E+11,"Block Group 2, Census Tract 90, Orleans Parish, Louisiana",360,87,286,78,74,68
1500000US220710090003,2.21E+11,"Block Group 3, Census Tract 90, Orleans Parish, Louisiana",538,93,428,92,110,87
1500000US220710091001,2.21E+11,"Block Group 1, Census Tract 91, Orleans Parish, Louisiana",439,108,342,105,97,73
1500000US220710091002,2.21E+11,"Block Group 2, Census Tract 91, Orleans Parish, Louisiana",337,90,186,68,151,84
1500000US220710091003,2.21E+11,"Block Group 3, Census Tract 91, Orleans Parish, Louisiana",254,96,181,84,73,53
1500000US220710091004,2.21E+11,"Block Group 4, Census Tract 91, Orleans Parish, Louisiana",488,99,409,98,79,58
1500000US220710092001,2.21E+11,"Block Group 1, Census Tract 92, Orleans Parish, Louisiana",189,69,150,69,39,38
1500000US220710092002,2.21E+11,"Block Group 2, Census Tract 92, Orleans Parish, Louisiana",291,66,216,56,75,44
1500000US220710092003,2.21E+11,"Block Group 3, Census Tract 92, Orleans Parish, Louisiana",300,70,243,62,57,47
1500000US220710094001,2.21E+11,"Block Group 1, Census Tract 94, Orleans Parish, Louisiana",260,59,164,57,96,43
1500000US220710094002,2.21E+11,"Block Group 2, Census Tract 94, Orleans Parish, Louisiana",132,46,74,39,58,34
1500000US220710094003,2.21E+11,"Block Group 3, Census Tract 94, Orleans Parish, Louisiana",160,53,114,48,46,28
1500000US220710094004,2.21E+11,"Block Group 4, Census Tract 94, Orleans Parish, Louisiana",219,55,150,44,69,39
1500000US220710096001,2.21E+11,"Block Group 1, Census Tract 96, Orleans Parish, Louisiana",292,61,262,59,30,34
1500000US220710096002,2.21E+11,"Block Group 2, Census Tract 96, Orleans Parish, Louisiana",315,60,246,59,69,46
1500000US220710096003,2.21E+11,"Block Group 3, Census Tract 96, Orleans Parish, Louisiana",240,54,228,53,12,21
1500000US220710097001,2.21E+11,"Block Group 1, Census Tract 97, Orleans Parish, Louisiana",415,57,368,61,47,44
1500000US220710097002,2.21E+11,"Block Group 2, Census Tract 97, Orleans Parish, Louisiana",381,67,353,66,28,37
1500000US220710099001,2.21E+11,"Block Group 1, Census Tract 99, Orleans Parish, Louisiana",597,92,520,87,77,70
1500000US220710099002,2.21E+11,"Block Group 2, Census Tract 99, Orleans Parish, Louisiana",524,87,443,77,81,69
1500000US220710099003,2.21E+11,"Block Group 3, Census Tract 99, Orleans Parish, Louisiana",597,98,475,98,122,81
1500000US220710100001,2.21E+11,"Block Group 1, Census Tract 100, Orleans Parish, Louisiana",216,60,142,60,74,44
1500000US220710100002,2.21E+11,"Block Group 2, Census Tract 100, Orleans Parish, Louisiana",232,51,193,54,39,32
1500000US220710100003,2.21E+11,"Block Group 3, Census Tract 100, Orleans Parish, Louisiana",399,70,308,69,91,46
1500000US220710100004,2.21E+11,"Block Group 4, Census Tract 100, Orleans Parish, Louisiana",191,56,121,38,70,49
1500000US220710101001,2.21E+11,"Block Group 1, Census Tract 101, Orleans Parish, Louisiana",415,84,318,83,97,67
1500000US220710101002,2.21E+11,"Block Group 2, Census Tract 101, Orleans Parish, Louisiana",855,93,607,87,248,103
1500000US220710102001,2.21E+11,"Block Group 1, Census Tract 102, Orleans Parish, Louisiana",174,66,151,63,23,27
1500000US220710102002,2.21E+11,"Block Group 2, Census Tract 102, Orleans Parish, Louisiana",200,69,102,52,98,58
1500000US220710102003,2.21E+11,"Block Group 3, Census Tract 102, Orleans Parish, Louisiana",201,58,128,55,73,51
1500000US220710102004,2.21E+11,"Block Group 4, Census Tract 102, Orleans Parish, Louisiana",155,48,155,48,0,12
1500000US220710102005,2.21E+11,"Block Group 5, Census Tract 102, Orleans Parish, Louisiana",262,65,200,53,62,55
1500000US220710103001,2.21E+11,"Block Group 1, Census Tract 103, Orleans Parish, Louisiana",333,87,259,87,74,44
1500000US220710103002,2.21E+11,"Block Group 2, Census Tract 103, Orleans Parish, Louisiana",416,93,329,88,87,57
1500000US220710103003,2.21E+11,"Block Group 3, Census Tract 103, Orleans Parish, Louisiana",322,64,263,57,59,37
1500000US220710103004,2.21E+11,"Block Group 4, Census Tract 103, Orleans Parish, Louisiana",239,78,182,82,57,38
1500000US220710106001,2.21E+11,"Block Group 1, Census Tract 106, Orleans Parish, Louisiana",347,60,316,60,31,29
1500000US220710106002,2.21E+11,"Block Group 2, Census Tract 106, Orleans Parish, Louisiana",458,62,366,75,92,58
1500000US220710107001,2.21E+11,"Block Group 1, Census Tract 107, Orleans Parish, Louisiana",335,63,280,61,55,42
1500000US220710107002,2.21E+11,"Block Group 2, Census Tract 107, Orleans Parish, Louisiana",718,76,593,85,125,76
1500000US220710108001,2.21E+11,"Block Group 1, Census Tract 108, Orleans Parish, Louisiana",191,45,173,42,18,23
1500000US220710108002,2.21E+11,"Block Group 2, Census Tract 108, Orleans Parish, Louisiana",568,56,492,62,76,45
1500000US220710109001,2.21E+11,"Block Group 1, Census Tract 109, Orleans Parish, Louisiana",301,89,269,76,32,50
1500000US220710109002,2.21E+11,"Block Group 2, Census Tract 109, Orleans Parish, Louisiana",533,91,504,92,29,34
1500000US220710109003,2.21E+11,"Block Group 3, Census Tract 109, Orleans Parish, Louisiana",438,92,381,90,57,49
1500000US220710109004,2.21E+11,"Block Group 4, Census Tract 109, Orleans Parish, Louisiana",307,84,272,84,35,58
1500000US220710111001,2.21E+11,"Block Group 1, Census Tract 111, Orleans Parish, Louisiana",270,67,192,59,78,52
1500000US220710111002,2.21E+11,"Block Group 2, Census Tract 111, Orleans Parish, Louisiana",328,70,291,68,37,36
1500000US220710111003,2.21E+11,"Block Group 3, Census Tract 111, Orleans Parish, Louisiana",266,63,154,50,112,63
1500000US220710112001,2.21E+11,"Block Group 1, Census Tract 112, Orleans Parish, Louisiana",300,63,288,62,12,19
1500000US220710112002,2.21E+11,"Block Group 2, Census Tract 112, Orleans Parish, Louisiana",343,47,309,45,34,29
1500000US220710114001,2.21E+11,"Block Group 1, Census Tract 114, Orleans Parish, Louisiana",533,93,445,86,88,76
1500000US220710114002,2.21E+11,"Block Group 2, Census Tract 114, Orleans Parish, Louisiana",555,83,555,83,0,12
1500000US220710115001,2.21E+11,"Block Group 1, Census Tract 115, Orleans Parish, Louisiana",381,66,286,52,95,57
1500000US220710115002,2.21E+11,"Block Group 2, Census Tract 115, Orleans Parish, Louisiana",446,70,350,73,96,57
1500000US220710116001,2.21E+11,"Block Group 1, Census Tract 116, Orleans Parish, Louisiana",398,47,354,54,44,39
1500000US220710116002,2.21E+11,"Block Group 2, Census Tract 116, Orleans Parish, Louisiana",328,44,304,40,24,29
1500000US220710117001,2.21E+11,"Block Group 1, Census Tract 117, Orleans Parish, Louisiana",233,72,210,64,23,36
1500000US220710117002,2.21E+11,"Block Group 2, Census Tract 117, Orleans Parish, Louisiana",282,57,240,58,42,37
1500000US220710117003,2.21E+11,"Block Group 3, Census Tract 117, Orleans Parish, Louisiana",362,71,315,75,47,45
1500000US220710117004,2.21E+11,"Block Group 4, Census Tract 117, Orleans Parish, Louisiana",367,68,330,60,37,43
1500000US220710119001,2.21E+11,"Block Group 1, Census Tract 119, Orleans Parish, Louisiana",262,64,226,61,36,38
1500000US220710119002,2.21E+11,"Block Group 2, Census Tract 119, Orleans Parish, Louisiana",277,48,247,49,30,34
1500000US220710119003,2.21E+11,"Block Group 3, Census Tract 119, Orleans Parish, Louisiana",242,55,225,53,17,27
1500000US220710120001,2.21E+11,"Block Group 1, Census Tract 120, Orleans Parish, Louisiana",584,41,504,55,80,50
1500000US220710120002,2.21E+11,"Block Group 2, Census Tract 120, Orleans Parish, Louisiana",188,38,176,36,12,19
1500000US220710121011,2.21E+11,"Block Group 1, Census Tract 121.01, Orleans Parish, Louisiana",426,61,406,62,20,30
1500000US220710121012,2.21E+11,"Block Group 2, Census Tract 121.01, Orleans Parish, Louisiana",461,59,429,60,32,34
1500000US220710121021,2.21E+11,"Block Group 1, Census Tract 121.02, Orleans Parish, Louisiana",242,46,203,41,39,34
1500000US220710121022,2.21E+11,"Block Group 2, Census Tract 121.02, Orleans Parish, Louisiana",16,9,16,9,0,12
1500000US220710121023,2.21E+11,"Block Group 3, Census Tract 121.02, Orleans Parish, Louisiana",247,48,219,47,28,25
1500000US220710122001,2.21E+11,"Block Group 1, Census Tract 122, Orleans Parish, Louisiana",536,69,495,70,41,33
1500000US220710122002,2.21E+11,"Block Group 2, Census Tract 122, Orleans Parish, Louisiana",456,75,426,73,30,47
1500000US220710123001,2.21E+11,"Block Group 1, Census Tract 123, Orleans Parish, Louisiana",278,72,229,62,49,40
1500000US220710123002,2.21E+11,"Block Group 2, Census Tract 123, Orleans Parish, Louisiana",424,78,336,74,88,52
1500000US220710123003,2.21E+11,"Block Group 3, Census Tract 123, Orleans Parish, Louisiana",359,70,344,71,15,23
1500000US220710124001,2.21E+11,"Block Group 1, Census Tract 124, Orleans Parish, Louisiana",390,70,267,76,123,61
1500000US220710124002,2.21E+11,"Block Group 2, Census Tract 124, Orleans Parish, Louisiana",510,70,405,62,105,61
1500000US220710125001,2.21E+11,"Block Group 1, Census Tract 125, Orleans Parish, Louisiana",416,62,278,57,138,62
1500000US220710125002,2.21E+11,"Block Group 2, Census Tract 125, Orleans Parish, Louisiana",600,71,528,71,72,46
1500000US220710126001,2.21E+11,"Block Group 1, Census Tract 126, Orleans Parish, Louisiana",336,49,294,49,42,36
1500000US220710126002,2.21E+11,"Block Group 2, Census Tract 126, Orleans Parish, Louisiana",388,61,317,64,71,58
1500000US220710126003,2.21E+11,"Block Group 3, Census Tract 126, Orleans Parish, Louisiana",295,60,270,59,25,23
1500000US220710127001,2.21E+11,"Block Group 1, Census Tract 127, Orleans Parish, Louisiana",446,94,343,77,103,77
1500000US220710127002,2.21E+11,"Block Group 2, Census Tract 127, Orleans Parish, Louisiana",297,87,209,60,88,73
1500000US220710127003,2.21E+11,"Block Group 3, Census Tract 127, Orleans Parish, Louisiana",255,75,220,67,35,50
1500000US220710127004,2.21E+11,"Block Group 4, Census Tract 127, Orleans Parish, Louisiana",247,49,235,47,12,17
1500000US220710128001,2.21E+11,"Block Group 1, Census Tract 128, Orleans Parish, Louisiana",312,73,253,71,59,41
1500000US220710128002,2.21E+11,"Block Group 2, Census Tract 128, Orleans Parish, Louisiana",364,58,340,58,24,26
1500000US220710128003,2.21E+11,"Block Group 3, Census Tract 128, Orleans Parish, Louisiana",498,73,378,61,120,61
1500000US220710129001,2.21E+11,"Block Group 1, Census Tract 129, Orleans Parish, Louisiana",534,66,470,68,64,58
1500000US220710129002,2.21E+11,"Block Group 2, Census Tract 129, Orleans Parish, Louisiana",375,64,283,59,92,55
1500000US220710130001,2.21E+11,"Block Group 1, Census Tract 130, Orleans Parish, Louisiana",334,80,293,78,41,45
1500000US220710130002,2.21E+11,"Block Group 2, Census Tract 130, Orleans Parish, Louisiana",317,73,239,67,78,52
1500000US220710130003,2.21E+11,"Block Group 3, Census Tract 130, Orleans Parish, Louisiana",230,68,214,64,16,25
1500000US220710131001,2.21E+11,"Block Group 1, Census Tract 131, Orleans Parish, Louisiana",206,52,115,44,91,44
1500000US220710131002,2.21E+11,"Block Group 2, Census Tract 131, Orleans Parish, Louisiana",225,52,146,44,79,40
1500000US220710131003,2.21E+11,"Block Group 3, Census Tract 131, Orleans Parish, Louisiana",168,53,157,49,11,18
1500000US220710131004,2.21E+11,"Block Group 4, Census Tract 131, Orleans Parish, Louisiana",262,59,143,56,119,57
1500000US220710132001,2.21E+11,"Block Group 1, Census Tract 132, Orleans Parish, Louisiana",229,64,208,66,21,34
1500000US220710132002,2.21E+11,"Block Group 2, Census Tract 132, Orleans Parish, Louisiana",487,116,313,101,174,86
1500000US220710132003,2.21E+11,"Block Group 3, Census Tract 132, Orleans Parish, Louisiana",317,90,294,85,23,36
1500000US220710132004,2.21E+11,"Block Group 4, Census Tract 132, Orleans Parish, Louisiana",275,68,245,63,30,37
1500000US220710133011,2.21E+11,"Block Group 1, Census Tract 133.01, Orleans Parish, Louisiana",353,68,315,60,38,48
1500000US220710133012,2.21E+11,"Block Group 2, Census Tract 133.01, Orleans Parish, Louisiana",599,88,504,74,95,84
1500000US220710133013,2.21E+11,"Block Group 3, Census Tract 133.01, Orleans Parish, Louisiana",214,56,180,41,34,47
1500000US220710133014,2.21E+11,"Block Group 4, Census Tract 133.01, Orleans Parish, Louisiana",523,87,412,86,111,87
1500000US220710133021,2.21E+11,"Block Group 1, Census Tract 133.02, Orleans Parish, Louisiana",683,63,523,71,160,76
1500000US220710133022,2.21E+11,"Block Group 2, Census Tract 133.02, Orleans Parish, Louisiana",416,55,358,52,58,38
1500000US220710134001,2.21E+11,"Block Group 1, Census Tract 134, Orleans Parish, Louisiana",568,105,239,70,329,111
1500000US220710134002,2.21E+11,"Block Group 2, Census Tract 134, Orleans Parish, Louisiana",535,84,395,64,140,70
1500000US220710134003,2.21E+11,"Block Group 3, Census Tract 134, Orleans Parish, Louisiana",1157,125,815,124,342,112
1500000US220710135001,2.21E+11,"Block Group 1, Census Tract 135, Orleans Parish, Louisiana",571,118,226,77,345,125
1500000US220710135002,2.21E+11,"Block Group 2, Census Tract 135, Orleans Parish, Louisiana",707,152,342,95,365,139
1500000US220710135003,2.21E+11,"Block Group 3, Census Tract 135, Orleans Parish, Louisiana",908,189,318,95,590,189
1500000US220710135004,2.21E+11,"Block Group 4, Census Tract 135, Orleans Parish, Louisiana",717,162,416,133,301,128
1500000US220710136001,2.21E+11,"Block Group 1, Census Tract 136, Orleans Parish, Louisiana",288,61,261,59,27,27
1500000US220710136002,2.21E+11,"Block Group 2, Census Tract 136, Orleans Parish, Louisiana",261,63,166,45,95,61
1500000US220710137001,2.21E+11,"Block Group 1, Census Tract 137, Orleans Parish, Louisiana",0,12,0,12,0,12
1500000US220710137002,2.21E+11,"Block Group 2, Census Tract 137, Orleans Parish, Louisiana",102,47,69,30,33,38
1500000US220710137003,2.21E+11,"Block Group 3, Census Tract 137, Orleans Parish, Louisiana",300,61,278,63,22,25
1500000US220710137004,2.21E+11,"Block Group 4, Census Tract 137, Orleans Parish, Louisiana",591,93,455,81,136,63
1500000US220710138001,2.21E+11,"Block Group 1, Census Tract 138, Orleans Parish, Louisiana",325,62,245,56,80,38
1500000US220710138002,2.21E+11,"Block Group 2, Census Tract 138, Orleans Parish, Louisiana",282,61,263,59,19,22
1500000US220710138003,2.21E+11,"Block Group 3, Census Tract 138, Orleans Parish, Louisiana",360,66,306,64,54,36
1500000US220710139001,2.21E+11,"Block Group 1, Census Tract 139, Orleans Parish, Louisiana",482,82,282,68,200,69
1500000US220710139002,2.21E+11,"Block Group 2, Census Tract 139, Orleans Parish, Louisiana",762,96,590,92,172,79
1500000US220710140001,2.21E+11,"Block Group 1, Census Tract 140, Orleans Parish, Louisiana",98,40,93,39,5,11
1500000US220710140002,2.21E+11,"Block Group 2, Census Tract 140, Orleans Parish, Louisiana",557,85,422,74,135,75
1500000US220710140003,2.21E+11,"Block Group 3, Census Tract 140, Orleans Parish, Louisiana",351,69,302,66,49,34
1500000US220710140004,2.21E+11,"Block Group 4, Census Tract 140, Orleans Parish, Louisiana",60,41,50,38,10,17
1500000US220710141001,2.21E+11,"Block Group 1, Census Tract 141, Orleans Parish, Louisiana",492,86,492,86,0,12
1500000US220710141002,2.21E+11,"Block Group 2, Census Tract 141, Orleans Parish, Louisiana",211,77,142,69,69,59
1500000US220710141003,2.21E+11,"Block Group 3, Census Tract 141, Orleans Parish, Louisiana",434,97,422,95,12,20
1500000US220710142001,2.21E+11,"Block Group 1, Census Tract 142, Orleans Parish, Louisiana",277,70,204,61,73,49
1500000US220710142002,2.21E+11,"Block Group 2, Census Tract 142, Orleans Parish, Louisiana",583,90,530,96,53,56
1500000US220710142003,2.21E+11,"Block Group 3, Census Tract 142, Orleans Parish, Louisiana",203,73,203,73,0,12
1500000US220710143001,2.21E+11,"Block Group 1, Census Tract 143, Orleans Parish, Louisiana",241,58,224,58,17,19
1500000US220710143002,2.21E+11,"Block Group 2, Census Tract 143, Orleans Parish, Louisiana",76,32,76,32,0,12
1500000US220710143003,2.21E+11,"Block Group 3, Census Tract 143, Orleans Parish, Louisiana",563,74,410,74,153,57
1500000US220710144001,2.21E+11,"Block Group 1, Census Tract 144, Orleans Parish, Louisiana",196,49,142,47,54,37
1500000US220710144002,2.21E+11,"Block Group 2, Census Tract 144, Orleans Parish, Louisiana",425,67,335,74,90,56
1500000US220710144003,2.21E+11,"Block Group 3, Census Tract 144, Orleans Parish, Louisiana",401,79,330,76,71,48
1500000US220710145001,2.21E+11,"Block Group 1, Census Tract 145, Orleans Parish, Louisiana",0,12,0,12,0,12
1500000US220719800001,2.21E+11,"Block Group 1, Census Tract 9800, Orleans Parish, Louisiana",0,12,0,12,0,12
1500000US220719801001,2.21E+11,"Block Group 1, Census Tract 9801, Orleans Parish, Louisiana",9,12,0,12,9,12
1500000US220719900000,2.21E+11,"Block Group 0, Census Tract 9900, Orleans Parish, Louisiana",0,12,0,12,0,12
